
  Date     ,Narration                                                                                                                ,Value Dat,Debit Amount       ,Credit Amount      ,Chq/Ref Number   ,Closing Balance
 01/01/24  ,UPI-SHARANABASAVA-9008171513@AXL-SBIN0020369-400114908411-UPI                                                            ,01/01/24 ,         117.00     ,           0.00     ,0000400114908411       ,      241411.99  
 01/01/24  ,UPI-SAKTHIVEL-9880848984@BARODAMPAY-BARB0BYRASA-400122443015-UPI                                                         ,01/01/24 ,         143.00     ,           0.00     ,0000400122443015       ,      241268.99  
 01/01/24  ,UPI-VIDHYA P N-VIDYANAGARAJ0@OKAXIS-CNRB0000033-400122714803-UPI                                                         ,01/01/24 ,          20.00     ,           0.00     ,0000400122714803       ,      241248.99  
 01/01/24  ,UPI-SWIGGY-UPISWIGGY@ICICI-ICIC0DC0099-400127079880-UPI                                                                  ,01/01/24 ,         202.00     ,           0.00     ,0000400127079880       ,      241046.99  
 01/01/24  ,UPI-MYNTRACOM-MYNTRA.PAYU@AXISBANK-UTIB0000000-400167720347-RRRPPPL18845926420                                           ,01/01/24 ,           0.00     ,        1844.00     ,0000400167720347       ,      242890.99  
 01/01/24  ,50400292038639- RD INSTALLMENT-JAN 2024                                                                                  ,01/01/24 ,       15000.00     ,           0.00     ,000000000000000        ,      227890.99  
 02/01/24  ,UPI-BACCHU SATISH KUMAR-SATISHBACCHUPAYTM@YBL-PYTM0123456-400259916873-UPI                                               ,02/01/24 ,       21500.00     ,           0.00     ,0000400259916873       ,      206390.99  
 02/01/24  ,UPI-CHAI FUSION CAFE-PAYTMQRK2HRGV779M@PAYTM-PYTM0123456-400277404207-UPI                                                ,02/01/24 ,          33.00     ,           0.00     ,0000400277404207       ,      206357.99  
 02/01/24  ,UPI-RAJALAKSHMI  NANDAKU-RAJI.NANDAKUMAR@OKSBI-SBIN0011926-400289486379-UPI                                              ,03/01/24 ,       10000.00     ,           0.00     ,0000400289486379       ,      196357.99  
 03/01/24  ,UPI-SWIGGY-SWIGGY.STORES@AXISBANK-UTIB0000100-400393870963-SWIGGY ORDER ID 16                                            ,03/01/24 ,         542.00     ,           0.00     ,0000400393870963       ,      195815.99  
 03/01/24  ,UPI-KAMALA  BHANDARI-KAMALABHANDARI06433@OKHDFCBANK-KKBK0008075-400301037074-UPI                                         ,03/01/24 ,        1200.00     ,           0.00     ,0000400301037074       ,      194615.99  
 03/01/24  ,UPI-CHAI FUSION CAFE-PAYTMQR18NIB57I2I@PAYTM-PYTM0123456-400312112023-UPI                                                ,03/01/24 ,          45.00     ,           0.00     ,0000400312112023       ,      194570.99  
 04/01/24  ,UPI-INDRAJEET  KUMAR-ENJEETKUMAR533@OKSBI-SBIN0004893-400439426995-UPI                                                   ,04/01/24 ,         186.00     ,           0.00     ,0000400439426995       ,      194384.99  
 04/01/24  ,UPI-INDIAN CLEARING CORP-NBT.ELEMENTS@ICICI-ICIC0DC0099-400450647426-PAYMENT REQUEST FO                                  ,04/01/24 ,       10000.00     ,           0.00     ,0000400450647426       ,      184384.99  
 04/01/24  ,UPI-INDIAN CLEARING CORP-NBT.ELEMENTS@ICICI-ICIC0DC0099-400450695808-PAYMENT REQUEST FO                                  ,04/01/24 ,       10000.00     ,           0.00     ,0000400450695808       ,      174384.99  
 04/01/24  ,UPI-INDIAN CLEARING CORP-NBT.ELEMENTS@ICICI-ICIC0DC0099-400450740598-PAYMENT REQUEST FO                                  ,04/01/24 ,       15000.00     ,           0.00     ,0000400450740598       ,      159384.99  
 04/01/24  ,UPI-JHUNNA  KUMAR-876635771111@AXL-KKBK0008125-400458437650-UPI                                                          ,04/01/24 ,         186.00     ,           0.00     ,0000400458437650       ,      159198.99  
 04/01/24  ,UPI-POTTABATHULA BHARGAV-BHARGAVNETHA@OKSBI-SBIN0002207-400458958343-UPI                                                 ,04/01/24 ,        1760.00     ,           0.00     ,0000400458958343       ,      157438.99  
 04/01/24  ,UPI-AJAI SINGH-AJAISINGH7-1@OKICICI-CITI0000004-400459017561-UPI                                                         ,04/01/24 ,         284.00     ,           0.00     ,0000400459017561       ,      157154.99  
 04/01/24  ,UPI-MYNTRACOM-MYNTRA.PAYU@AXISBANK-UTIB0000000-400485247144-UPI TRANSACTION                                              ,04/01/24 ,        2322.00     ,           0.00     ,0000400485247144       ,      154832.99  
 05/01/24  ,UPI-SWIGGY-SWIGGY.RZP@HDFCBANK-HDFC0000053-400592203992-PAYVIARAZORPAY                                                   ,05/01/24 ,         301.00     ,           0.00     ,0000400592203992       ,      154531.99  
 06/01/24  ,UPI-ANITHA M-PAYTMQR281005050101E62VOVBLXZ3L@PAYTM-PYTM0123456-400617140421-UPI                                          ,06/01/24 ,          10.00     ,           0.00     ,0000400617140421       ,      154521.99  
 06/01/24  ,UPI-SNEHA  BALAJI-8073315634@YBL-KKBK0008056-400617687729-UPI                                                            ,06/01/24 ,          25.00     ,           0.00     ,0000400617687729       ,      154496.99  
 06/01/24  ,UPI-KAVYA P-KAVYAPHSN@OKAXIS-KARB0000345-400625388212-UPI                                                                ,06/01/24 ,          10.00     ,           0.00     ,0000400625388212       ,      154486.99  
 06/01/24  ,UPI-SATYAGOUDA B MANAGUT-PAYTMQRXZYCU2TG6W@PAYTM-PYTM0123456-400631986735-UPI                                            ,06/01/24 ,          46.00     ,           0.00     ,0000400631986735       ,      154440.99  
 06/01/24  ,UPI-M FAYAZ-Q920184385@YBL-YESB0YBLUPI-400632141906-UPI                                                                  ,06/01/24 ,          60.00     ,           0.00     ,0000400632141906       ,      154380.99  
 06/01/24  ,UPI-RIGI-RIGI.RZP@ICICI-ICIC0DC0099-400636476719-PAYVIARAZORPAY                                                          ,06/01/24 ,         589.00     ,           0.00     ,0000400636476719       ,      153791.99  
 07/01/24  ,UPI-BLINKIT-BLINKIT.PAYU@HDFCBANK-HDFC0000499-400745344093-UPI TRANSACTION FO                                            ,07/01/24 ,         548.00     ,           0.00     ,0000400745344093       ,      153243.99  
 07/01/24  ,UPI-RAM  BHADHUR-RAMESHSHAHI813@OKSBI-SBIN0040784-400755150236-UPI                                                       ,07/01/24 ,          50.00     ,           0.00     ,0000400755150236       ,      153193.99  
 07/01/24  ,50400329652447- RD INSTALLMENT-JAN 2024                                                                                  ,07/01/24 ,       10000.00     ,           0.00     ,000000000000000        ,      143193.99  
 08/01/24  ,UPI-GREEN TRENDS-PAYTM-81049294@PAYTM-PYTM0123456-400800065414-UPI                                                       ,08/01/24 ,          54.00     ,           0.00     ,0000400800065414       ,      143139.99  
 09/01/24  ,UPI-VINODAN-PAYTMQR281005050101SXVT1B8MQ888@PAYTM-PYTM0123456-400937152654-UPI                                           ,09/01/24 ,          70.00     ,           0.00     ,0000400937152654       ,      143069.99  
 10/01/24  ,UPI-SWIGGY-SWIGGY@YESPAY-YESB0YESUPI-401054729018-UPI                                                                    ,10/01/24 ,         140.00     ,           0.00     ,0000401054729018       ,      142929.99  
 10/01/24  ,UPI-MYNTRACOM-MYNTRA.PAYU@AXISBANK-UTIB0000000-401026040649-RRRAXI034CC9D52AFF                                           ,10/01/24 ,           0.00     ,         249.00     ,0000401026040649       ,      143178.99  
 10/01/24  ,UPI-MYNTRACOM-MYNTRA.PAYU@AXISBANK-UTIB0000000-401026232458-RRRAXI034CC9D52AFF                                           ,10/01/24 ,           0.00     ,        1459.00     ,0000401026232458       ,      144637.99  
 10/01/24  ,UPI-MYNTRACOM-MYNTRA.PAYU@AXISBANK-UTIB0000000-401026433017-RRRAXI034CC9D52AFF                                           ,10/01/24 ,           0.00     ,         594.00     ,0000401026433017       ,      145231.99  
 10/01/24  ,UPI-SWIGGY-SWIGGY@YESPAY-YESB0YESUPI-401080804462-UPI                                                                    ,10/01/24 ,         463.00     ,           0.00     ,0000401080804462       ,      144768.99  
 10/01/24  ,UPI-MYNTRACOM-MYNTRA.PAYU@AXISBANK-UTIB0000000-401087786526-UPI TRANSACTION FO                                           ,10/01/24 ,        1553.00     ,           0.00     ,0000401087786526       ,      143215.99  
 11/01/24  ,UPI-SPOTIFY-BILLDESKPG.SPOTIFY@HDFCBANK-HDFC0000499-401104791663-PAY                                                     ,11/01/24 ,        1189.00     ,           0.00     ,0000401104791663       ,      142026.99  
 11/01/24  ,UPI-MR R MUNIYAPPA RAO-RMUNIYAPPARO08@IBL-IDIB000K791-401115970155-UPI                                                   ,11/01/24 ,         237.00     ,           0.00     ,0000401115970155       ,      141789.99  
 11/01/24  ,UPI-RAVI K-BHARATPE90727371486@YESBANKLTD-YESB0YESUPI-401120377791-PAY TO BHARATPE ME                                    ,11/01/24 ,         256.00     ,           0.00     ,0000401120377791       ,      141533.99  
 12/01/24  ,SI HGACP0A1DA0137445379 AIRTEL -12/01/24                                                                                 ,12/01/24 ,         470.82     ,           0.00     ,000000000000000        ,      141063.17  
 13/01/24  ,UPI-BLINKIT-GROFERS.PAYU@ICICI-ICIC0DC0099-401368311845-UPI TRANSACTION FO                                               ,13/01/24 ,         611.00     ,           0.00     ,0000401368311845       ,      140452.17  
 13/01/24  ,UPI-M FAYAZ-Q399695192@YBL-YESB0YBLUPI-401393518658-UPI                                                                  ,13/01/24 ,          60.00     ,           0.00     ,0000401393518658       ,      140392.17  
 14/01/24  ,UPI-SWIGGY-SWIGGY@YESPAY-YESB0YESUPI-401409894667-UPI                                                                    ,14/01/24 ,         485.00     ,           0.00     ,0000401409894667       ,      139907.17  
 14/01/24  ,UPI-BABU V-BHARATPE.90057290670@FBPE-FDRL0001382-401412708803-PAY TO BHARATPE ME                                         ,14/01/24 ,         118.00     ,           0.00     ,0000401412708803       ,      139789.17  
 14/01/24  ,UPI-RIYA JAIN-RIYAJAIN-8295576.PAYU@INDUS-INDB0002201-401489566642-UPI TRANSACTION                                       ,14/01/24 ,         720.00     ,           0.00     ,0000401489566642       ,      139069.17  
 14/01/24  ,UPI-MANJUNATH G M-9663500928@AXL-BARB0VJSRNP-401425541206-UPI                                                            ,14/01/24 ,         124.00     ,           0.00     ,0000401425541206       ,      138945.17  
 15/01/24  ,UPI-SRI UDUPI PARK-PAYTMQR281005050101TUOCKETPJXC3@PAYTM-PYTM0123456-401543669754-UPI                                    ,15/01/24 ,          80.00     ,           0.00     ,0000401543669754       ,      138865.17  
 15/01/24  ,UPI-VISHWANATH SHETTY-PAYTMQRPQ99DQ6R80@PAYTM-PYTM0123456-401543708009-UPI                                               ,15/01/24 ,          15.00     ,           0.00     ,0000401543708009       ,      138850.17  
 15/01/24  ,UPI-BLINKIT-GROFERS.PAYU@ICICI-ICIC0DC0099-401545222129-UPI TRANSACTION FO                                               ,15/01/24 ,         330.00     ,           0.00     ,0000401545222129       ,      138520.17  
 15/01/24  ,UPI-MYNTRACOM-MYNTRA.PAYU@AXISBANK-UTIB0000000-401556068505-RRRPPPL18931964398                                           ,15/01/24 ,           0.00     ,         499.00     ,0000401556068505       ,      139019.17  
 15/01/24  ,UPI-CHAI FUSION CAFE-PAYTMQR18NIB57I2I@PAYTM-PYTM0123456-401560018478-UPI                                                ,15/01/24 ,          15.00     ,           0.00     ,0000401560018478       ,      139004.17  
 16/01/24  ,UPI-CHAI FUSION CAFE-PAYTMQR18NIB57I2I@PAYTM-PYTM0123456-401696426911-UPI                                                ,16/01/24 ,          15.00     ,           0.00     ,0000401696426911       ,      138989.17  
 16/01/24  ,UPI-MYNTRA DESIGNS PRIVA-MYNTRADESIGNSP.PAYU@MAIRTEL-AIRP0000001-401621862916-UPI TRANSACTION                            ,16/01/24 ,         669.00     ,           0.00     ,0000401621862916       ,      138320.17  
 17/01/24  ,UPI-CHAI FUSION CAFE-PAYTMQR18NIB57I2I@PAYTM-PYTM0123456-401729303348-UPI                                                ,17/01/24 ,          30.00     ,           0.00     ,0000401729303348       ,      138290.17  
 18/01/24  ,UPI-GROFERS INDIA PRIVAT-GROFERSINDIA.RZP@AXISBANK-UTIB0000100-401847603092-PAYVIARAZORPAY                               ,18/01/24 ,         434.00     ,           0.00     ,0000401847603092       ,      137856.17  
 18/01/24  ,UPI-MYNTRACOM-MYNTRA.PAYU@AXISBANK-UTIB0000000-401872557563-UPI TRANSACTION FO                                           ,18/01/24 ,        2160.00     ,           0.00     ,0000401872557563       ,      135696.17  
 19/01/24  ,UPI-RAM  BHADHUR-RAMESHSHAHI813@OKSBI-SBIN0040784-401992673053-UPI                                                       ,19/01/24 ,          50.00     ,           0.00     ,0000401992673053       ,      135646.17  
 19/01/24  ,UPI-SRIKANTA KUMAR BEHER-GSJBAHH@YBL-SBIN0004739-401907764282-UPI                                                        ,19/01/24 ,          45.00     ,           0.00     ,0000401907764282       ,      135601.17  
 19/01/24  ,UPI-GANGANNA-PAYTMQR1CNHM6NRUZ@PAYTM-PYTM0123456-401914534462-UPI                                                        ,19/01/24 ,          58.00     ,           0.00     ,0000401914534462       ,      135543.17  
 19/01/24  ,UPI-M FAYAZ-Q399695192@YBL-YESB0YBLUPI-401914604268-UPI                                                                  ,19/01/24 ,          70.00     ,           0.00     ,0000401914604268       ,      135473.17  
 20/01/24  ,UPI-NANDAKUMAR V V-NKVV2011@OKHDFCBANK-HDFC0000671-402021208897-UPI                                                      ,20/01/24 ,       20000.00     ,           0.00     ,0000402021208897       ,      115473.17  
 20/01/24  ,UPI-SWIGGYINSTAMART-SWIGGYINSTAMART@YESPAY-YESB0YESUPI-402032186265-UPI                                                  ,20/01/24 ,         466.00     ,           0.00     ,0000402032186265       ,      115007.17  
 20/01/24  ,UPI-SWIGGYDINER-SWIGGYDINER@YESPAY-YESB0YESUPI-402037216571-UPI                                                          ,20/01/24 ,          11.00     ,           0.00     ,0000402037216571       ,      114996.17  
 20/01/24  ,UPI-SWIGGYDINER-SWIGGYDINER@YESPAY-YESB0YESUPI-402086322230-REFUND FOR JCWRKQI                                           ,20/01/24 ,           0.00     ,          11.00     ,0000402086322230       ,      115007.17  
 20/01/24  ,UPI-SWIGGYDINER-SWIGGYDINER@YESPAY-YESB0YESUPI-402037242679-UPI                                                          ,20/01/24 ,          11.00     ,           0.00     ,0000402037242679       ,      114996.17  
 20/01/24  ,UPI-CHAI FUSION CAFE-PAYTMQR18NIB57I2I@PAYTM-PYTM0123456-402040328777-UPI                                                ,20/01/24 ,          53.00     ,           0.00     ,0000402040328777       ,      114943.17  
 20/01/24  ,UPI-NISAR AHMED-9738526217@OKBIZAXIS-UTIB0000000-402047537990-UPI                                                        ,20/01/24 ,         180.00     ,           0.00     ,0000402047537990       ,      114763.17  
 21/01/24  ,UPI-VENKATESHAN V-7975767881@IBL-IBKL0000202-402150981568-UPI                                                            ,21/01/24 ,         201.00     ,           0.00     ,0000402150981568       ,      114562.17  
 21/01/24  ,UPI-SWIGGY-SWIGGY.STORES@AXISBANK-UTIB0000100-402155122590-SWIGGY ORDER ID 16                                            ,21/01/24 ,         398.00     ,           0.00     ,0000402155122590       ,      114164.17  
 21/01/24  ,UPI-BLINKIT-BLINKIT.PAYU@HDFCBANK-HDFC0000499-402155176595-UPI TRANSACTION FO                                            ,21/01/24 ,         240.00     ,           0.00     ,0000402155176595       ,      113924.17  
 21/01/24  ,UPI-DUNZO-DUNZO.CASHFREE@HDFCBANK-HDFC0004460-402161658507-UPI                                                           ,21/01/24 ,         207.00     ,           0.00     ,0000402161658507       ,      113717.17  
 21/01/24  ,UPI-N N VISHWANATHA-RNN340@IBL-KKBK0008062-402163231439-UPI                                                              ,21/01/24 ,         131.00     ,           0.00     ,0000402163231439       ,      113586.17  
 21/01/24  ,UPI-ZIYA ULLASHARIFF-GPAY-11209450750@OKBIZAXIS-UTIB0000000-402172388674-UPI                                             ,21/01/24 ,         103.00     ,           0.00     ,0000402172388674       ,      113483.17  
 21/01/24  ,UPI-GODADDY INDIA DOMAIN-GODADDY.CCA@HDFCBANK-HDFC0000499-402108204813-COLLECT                                           ,21/01/24 ,        1943.46     ,           0.00     ,0000402108204813       ,      111539.71  
 22/01/24  ,UPI-CHAI FUSION CAFE-PAYTMQR18NIB57I2I@PAYTM-PYTM0123456-402208771401-UPI                                                ,22/01/24 ,          45.00     ,           0.00     ,0000402208771401       ,      111494.71  
 23/01/24  ,UPI-GOOGLE PLAY-PLAYSTORE@AXISBANK-UTIB0000553-402398690928-MANDATEEXECUTE                                               ,23/01/24 ,         299.00     ,           0.00     ,0000402398690928       ,      111195.71  
 23/01/24  ,UPI-DEV NARAYANAN P-DEV.NAMBOOTHIRI-1@OKSBI-SBIN0011926-402330423417-UPI                                                 ,23/01/24 ,         600.00     ,           0.00     ,0000402330423417       ,      110595.71  
 23/01/24  ,UPI-BANGALORE ELECTRICIT-BESCL.BD@ICICI-ICIC0DC0099-402351588259-PAY                                                     ,23/01/24 ,         583.00     ,           0.00     ,0000402351588259       ,      110012.71  
 23/01/24  ,UPI-SWIGGYINSTAMART-SWIGGYINSTAMART@YESPAY-YESB0YESUPI-402353427255-UPI                                                  ,23/01/24 ,         133.00     ,           0.00     ,0000402353427255       ,      109879.71  
 24/01/24  ,UPI-MYNTRA DESIGNS PRIVA-MYNTRADESIGNSP.PAYU@MAIRTEL-AIRP0000001-402412194841-REFUND FOR UPI RRN                         ,24/01/24 ,           0.00     ,         649.00     ,0000402412194841       ,      110528.71  
 24/01/24  ,POS 416021XXXXXX6709 NINA                                                                                                ,24/01/24 ,         920.00     ,           0.00     ,0000000000022559       ,      109608.71  
 24/01/24  ,UPI-SWIGGY-SWIGGYUPI@AXISBANK-UTIB0000000-402484711740-SWIGGY ORDER ID 16                                                ,24/01/24 ,         364.00     ,           0.00     ,0000402484711740       ,      109244.71  
 25/01/24  ,UPI-UBER INDIA SYSTEMS P-UBERRIDES@HDFCBANK-HDFC0000499-402591170872-UBERRIDE                                            ,25/01/24 ,           1.00     ,           0.00     ,0000402591170872       ,      109243.71  
 25/01/24  ,UPI-UBER INDIA SYSTEMS P-UBERRIDES@HDFCBANK-HDFC0000240-402515893395-CHARGE ADJUSTMENT                                   ,25/01/24 ,           0.00     ,           1.00     ,0000402515893395       ,      109244.71  
 25/01/24  ,UPI-TATA STARBUCKS PRIVA-PAYPHITATASTARBUCKSPVTLTDT2DOMDEP@YESBANK-YESB0000551-402591582379-UPI                          ,25/01/24 ,         714.00     ,           0.00     ,0000402591582379       ,      108530.71  
 25/01/24  ,UPI-SWIGGY DINERS-SWIGGYDINEIN@ICICI-ICIC0DC0099-402583192487-PAYMENT FOR SWIGGY                                         ,25/01/24 ,        2689.00     ,           0.00     ,0000402583192487       ,      105841.71  
 26/01/24  ,UPI-POONAM PARESH GUPTA-PARESHGUPTA73@OKSBI-SBIN0001183-402638762686-UPI                                                 ,26/01/24 ,         140.00     ,           0.00     ,0000402638762686       ,      105701.71  
 26/01/24  ,POS 416021XXXXXX6709 5160 PUNJAB GRIL                                                                                    ,26/01/24 ,        1097.00     ,           0.00     ,0000402608104221       ,      104604.71  
 26/01/24  ,UPI-EFFINGUT COLABA-EFFINGUTCOLABA.61738319@HDFCBANK-HDFC0000001-402654214769-UPI                                        ,26/01/24 ,        1016.00     ,           0.00     ,0000402654214769       ,      103588.71  
 26/01/24  ,UPI-RAJA RAMJI RAJBHAR-Q657171248@YBL-YESB0YBLUPI-402658281893-UPI                                                       ,26/01/24 ,          15.00     ,           0.00     ,0000402658281893       ,      103573.71  
 26/01/24  ,UPI-RAMBACHAN KRISHNA CH-JAGRUTICHAURASIA049@OKICICI-BARB0BORIVL-402661247264-UPI                                        ,26/01/24 ,         101.00     ,           0.00     ,0000402661247264       ,      103472.71  
 27/01/24  ,UPI-ATOMX CORPORATION PR-ATOMXCORPORATIO82.RZP@ICICI-ICIC0DC0099-402778746416-TAPXPOWEREDBYATOMX                         ,27/01/24 ,        1023.60     ,           0.00     ,0000402778746416       ,      102449.11  
 27/01/24  ,UPI-UBER INDIA SYSTEMS P-UBERRIDES@HDFCBANK-HDFC0000499-402722704363-CHARGE                                              ,27/01/24 ,         543.50     ,           0.00     ,0000402722704363       ,      101905.61  
 27/01/24  ,UPI-BIG TREE ENTERTAINME-MSWIPE.1400102821000018@KOTAK-KKBK0000958-402782283316-UPI                                      ,27/01/24 ,        1500.00     ,           0.00     ,0000402782283316       ,      100405.61  
 28/01/24  ,UPI-MO YUSUF KHAN-7827754592@PAYTM-PYTM0123456-402810387116-UPI                                                          ,28/01/24 ,         229.00     ,           0.00     ,0000402810387116       ,      100176.61  
 28/01/24  ,UPI-CAFE 2 0 COUNTER 1C -PAYTM-15011062@PAYTM-PYTM0123456-402812361934-UPI                                               ,28/01/24 ,         330.00     ,           0.00     ,0000402812361934       ,       99846.61  
 28/01/24  ,UPI-SRPL  2-PAYTM-75787376@PAYTM-PYTM0123456-402818703967-UPI                                                            ,28/01/24 ,         200.00     ,           0.00     ,0000402818703967       ,       99646.61  
 28/01/24  ,UPI-BMTC BUS KA57F2200-KA57F2200@CNRB-CNRB0000033-402825722244-PAY TO MERCHANT                                           ,28/01/24 ,         265.00     ,           0.00     ,0000402825722244       ,       99381.61  
 28/01/24  ,UPI-SWIGGY-SWIGGY@YESPAY-YESB0YESUPI-402831876678-UPI                                                                    ,28/01/24 ,         337.00     ,           0.00     ,0000402831876678       ,       99044.61  
 28/01/24  ,UPI-SWIGGY-SWIGGY@YESPAY-YESB0YESUPI-402833096548-UPI                                                                    ,28/01/24 ,         203.00     ,           0.00     ,0000402833096548       ,       98841.61  
 29/01/24  ,UPI-VARSHA NANDAKUMAR-VARSHU.NK@OKAXIS-PUNB0425700-402938217153-UPI                                                      ,29/01/24 ,        5000.00     ,           0.00     ,0000402938217153       ,       93841.61  
 29/01/24  ,UPI-FNP-FNP.RZP@AXISBANK-UTIB0001506-402939105568-EXFNP9632                                                              ,29/01/24 ,         923.00     ,           0.00     ,0000402939105568       ,       92918.61  
 30/01/24  ,NEFT CR-ICIC0000104-VISA CONSOLIDATED SU SALARY JAN2024-VAISHNAVI NANDAKUMAR-CMS3882832579 VISA CONSOLIDATED SU SALARY J ,30/01/24 ,           0.00     ,       92548.00     ,000CMS3882832579       ,      185466.61  
 30/01/24  ,UPI-CHAI FUSION CAFE-PAYTMQRK2HRGV779M@PAYTM-PYTM0123456-403096315166-UPI                                                ,30/01/24 ,          45.00     ,           0.00     ,0000403096315166       ,      185421.61  
 30/01/24  ,UPI-BLINKIT-PAYTM-70258461@PAYTM-PYTM0123456-403002285966-BLINKIT PAYMENT                                                ,30/01/24 ,         691.00     ,           0.00     ,0000403002285966       ,      184730.61  
 31/01/24  ,UPI-SWIGGY-SWIGGYUPI@AXISBANK-UTIB0000000-403112566817-SWIGGY ORDER ID 16                                                ,31/01/24 ,         142.00     ,           0.00     ,0000403112566817       ,      184588.61  
 31/01/24  ,UPI-VAISHNAVI NANDAKUMAR-VAISHOO.NK@OKSBI-PUNB0432900-403114034084-UPI                                                   ,31/01/24 ,       17000.00     ,           0.00     ,0000403114034084       ,      167588.61  
 31/01/24  ,UPI-NANDAKUMAR V V-NKVV2011@OKHDFCBANK-HDFC0000671-403114056360-UPI                                                      ,31/01/24 ,        5000.00     ,           0.00     ,0000403114056360       ,      162588.61  
 31/01/24  ,UPI-RAJALAKSHMI  NANDAKU-RAJI.NANDAKUMAR@OKSBI-SBIN0011926-403114061516-UPI                                              ,31/01/24 ,        7000.00     ,           0.00     ,0000403114061516       ,      155588.61  
 31/01/24  ,UPI-SWIGGY-SWIGGY.RZP@AXISBANK-UTIB0000100-403123508578-PAYVIARAZORPAY                                                   ,31/01/24 ,         352.00     ,           0.00     ,0000403123508578       ,      155236.61  

  Date     ,Narration                                                                                                                ,Value Dat,Debit Amount       ,Credit Amount      ,Chq/Ref Number   ,Closing Balance
 01/07/24  ,UPI-RAJALAKSHMI  NANDAKU-RAJI.NANDAKUMAR@OKSBI-SBIN0011926-418310325249-UPI                                              ,01/07/24 ,        7000.00     ,           0.00     ,0000418310325249       ,      152740.12  
 01/07/24  ,UPI-NANDAKUMAR V V-NKVV2011@OKHDFCBANK-HDFC0000671-418310331737-UPI                                                      ,01/07/24 ,        5000.00     ,           0.00     ,0000418310331737       ,      147740.12  
 01/07/24  ,50400292038639- RD INSTALLMENT-JUL 2024                                                                                  ,01/07/24 ,       15000.00     ,           0.00     ,000000000000000        ,      132740.12  
 02/07/24  ,CC 000537206XXXXXX5466 AUTOPAY SI-TAD                                                                                    ,02/07/24 ,       16276.00     ,           0.00     ,0000000595044468       ,      116464.12  
 02/07/24  ,UPI-K MADHAVI-SATISHBACCHU-2@OKHDFCBANK-HDFC0000214-418471147182-UPI                                                     ,02/07/24 ,       21500.00     ,           0.00     ,0000418471147182       ,       94964.12  
 02/07/24  ,UPI-ICCLGROWW-GROWW-BSE.GROWWPAY@HDFCBANK-HDFC0000060-418471219378-PAYMENT REQUEST FO                                    ,02/07/24 ,       15000.00     ,           0.00     ,0000418471219378       ,       79964.12  
 02/07/24  ,UPI-ICCLGROWW-GROWW-BSE.GROWWPAY@HDFCBANK-HDFC0000060-418471300901-PAYMENT REQUEST FO                                    ,02/07/24 ,       10000.00     ,           0.00     ,0000418471300901       ,       69964.12  
 02/07/24  ,UPI-SWIGGY-UPISWIGGY@ICICI-ICIC0DC0099-418475525272-UPI                                                                  ,02/07/24 ,         359.00     ,           0.00     ,0000418475525272       ,       69605.12  
 03/07/24  ,UPI-BUNDL TECHNOLOGIES P-SWIGGYINSTAMART.RZP@AXISBANK-UTIB0000100-418589526405-PAYVIARAZORPAY                            ,03/07/24 ,         724.00     ,           0.00     ,0000418589526405       ,       68881.12  
 03/07/24  ,UPI-RAM  BHADHUR-RAMESHSHAHI813@OKSBI-SBIN0040784-418593353053-UPI                                                       ,03/07/24 ,          50.00     ,           0.00     ,0000418593353053       ,       68831.12  
 03/07/24  ,UPI-RAJALAKSHMI  NANDAKU-RAJI.NANDAKUMAR@OKSBI-SBIN0011926-418596687719-UPI                                              ,03/07/24 ,        5000.00     ,           0.00     ,0000418596687719       ,       63831.12  
 03/07/24  ,UPI-VAISHNAVI NANDAKUMAR-VAISHOO.NK@OKSBI-PUNB0432900-418505198757-UPI                                                   ,03/07/24 ,       17000.00     ,           0.00     ,0000418505198757       ,       46831.12  
 04/07/24  ,UPI-BUNDL TECHNOLOGIES P-SWIGGYUPI@AXB-UTIB0000100-418638667997-UPI                                                      ,04/07/24 ,         299.00     ,           0.00     ,0000418638667997       ,       46532.12  
 04/07/24  ,UPI-SWIGGY LIMITED-SWIGGY.STORES@AXB-UTIB0000100-418649530203-UPI                                                        ,04/07/24 ,         370.00     ,           0.00     ,0000418649530203       ,       46162.12  
 04/07/24  ,UPI-M FAYAZ-Q399695192@YBL-YESB0YBLUPI-418664195405-UPI                                                                  ,04/07/24 ,          70.00     ,           0.00     ,0000418664195405       ,       46092.12  
 07/07/24  ,UPI-BUNDL TECHNOLOGIES P-SWIGGYUPI@AXB-UTIB0000100-418962757296-UPI                                                      ,07/07/24 ,         147.00     ,           0.00     ,0000418962757296       ,       45945.12  
 07/07/24  ,UPI-PLAYO-PLAYOPGONLINE@YBL-YESB0YBLUPI-418971946980-PLAYO ORDER ID ZWY                                                  ,07/07/24 ,         316.08     ,           0.00     ,0000418971946980       ,       45629.04  
 07/07/24  ,UPI-SWIGGY-SWIGGYSTORES@ICICI-ICIC0DC0099-418973826980-UPI                                                               ,07/07/24 ,         624.00     ,           0.00     ,0000418973826980       ,       45005.04  
 07/07/24  ,UPI-RAVI-LRAVI8435@OKAXIS-KARB0000923-418978916818-UPI                                                                   ,07/07/24 ,         136.00     ,           0.00     ,0000418978916818       ,       44869.04  
 07/07/24  ,UPI-SPORTSARC ENTERPRISE-VYAPAR.170966701495@HDFCBANK-HDFC0000001-418979277195-UPI                                       ,07/07/24 ,         220.00     ,           0.00     ,0000418979277195       ,       44649.04  
 07/07/24  ,UPI-MOUNESH  M-6360737449@AXL-SBIN0003994-418986172901-UPI                                                               ,07/07/24 ,         125.00     ,           0.00     ,0000418986172901       ,       44524.04  
 07/07/24  ,50400329652447- RD INSTALLMENT-JUL 2024                                                                                  ,07/07/24 ,       10000.00     ,           0.00     ,000000000000000        ,       34524.04  
 08/07/24  ,UPI-SUBWAY BAGMANE-FCBIZPJN275@FREECHARGE-UTIB0000000-419009238065-UPI                                                   ,08/07/24 ,         318.00     ,           0.00     ,0000419009238065       ,       34206.04  
 09/07/24  ,00600310040071-122245084395                                                                                              ,09/07/24 ,           0.00     ,        1736.00     ,0000407099029827       ,       35942.04  
 09/07/24  ,UPI-UBER INDIA SYSTEMS P-UBERRIDES@HDFCBANK-HDFC0000240-419162623723-CHARGE ADJUSTMENT                                   ,09/07/24 ,           0.00     ,           5.51     ,0000419162623723       ,       35947.55  
 09/07/24  ,UPI-UBER INDIA SYSTEMS P-UBERRIDES@HDFCBANK-HDFC0000240-419162643997-CHARGE ADJUSTMENT                                   ,09/07/24 ,           0.00     ,          25.22     ,0000419162643997       ,       35972.77  
 09/07/24  ,UPI-HEALTHY HABIT DREAM -PAYTMQR1I8T4J6YTA@PAYTM-YESB0PTMUPI-419164765283-UPI                                            ,09/07/24 ,         188.00     ,           0.00     ,0000419164765283       ,       35784.77  
 11/07/24  ,UPI-GROFERS INDIA PRIVAT-GROFERSINDIA.RZP@HDFCBANK-HDFC0000053-419337424930-PAYVIARAZORPAY                               ,11/07/24 ,         409.00     ,           0.00     ,0000419337424930       ,       35375.77  
 11/07/24  ,UPI-CHAI FUSION CAFE-PAYTMQR18NIB57I2I@PAYTM-YESB0PTMUPI-419349538624-UPI                                                ,11/07/24 ,          45.00     ,           0.00     ,0000419349538624       ,       35330.77  
 11/07/24  ,UPI-SHIVAKUMARA S-SHIVATNP-1@OKHDFCBANK-HDFC0003508-419357587565-UPI                                                     ,11/07/24 ,        1000.00     ,           0.00     ,0000419357587565       ,       34330.77  
 12/07/24  ,SI HGAEP0CCD00244117032 AIRTEL -12/07/24                                                                                 ,12/07/24 ,         470.82     ,           0.00     ,000000000000000        ,       33859.95  
 12/07/24  ,UPI-SURYANARAYANA A-BHARATPE90727285109@YESBANKLTD-YESB0YESUPI-419400075970-PAY TO BHARATPE ME                           ,13/07/24 ,         350.00     ,           0.00     ,0000419400075970       ,       33509.95  
 12/07/24  ,UPI-CLINTON  CHAKMA-9380941821@KOTAK-KKBK0008054-419402937012-UPI                                                        ,13/07/24 ,         271.00     ,           0.00     ,0000419402937012       ,       33238.95  
 13/07/24  ,UPI-SWIGGY-SWIGGY.RZP@AXISBANK-UTIB0000100-419523708919-PAYVIARAZORPAY                                                   ,13/07/24 ,         190.00     ,           0.00     ,0000419523708919       ,       33048.95  
 14/07/24  ,UPI-SWIGGY-SWIGGY773.RZP@ICICI-ICIC0DC0099-419648215189-PAYVIARAZORPAY                                                   ,14/07/24 ,         171.00     ,           0.00     ,0000419648215189       ,       32877.95  
 14/07/24  ,UPI-R NAGABUSHAN-N1036585@OKICICI-KARB0000913-419662233058-UPI                                                           ,14/07/24 ,         139.00     ,           0.00     ,0000419662233058       ,       32738.95  
 14/07/24  ,UPI-TONI AND GUY BROOKFI-D1912AA8.9740402716@ICICI-ICIC0DC0099-419662739996-UPI                                          ,14/07/24 ,          83.00     ,           0.00     ,0000419662739996       ,       32655.95  
 14/07/24  ,UPI-SWIGGY-SWIGGY.RZP@AXISBANK-UTIB0000100-419674107273-PAYVIARAZORPAY                                                   ,14/07/24 ,         280.00     ,           0.00     ,0000419674107273       ,       32375.95  
 15/07/24  ,UPI-RAM  BHADHUR-RAMESHSHAHI813@OKSBI-SBIN0040784-419705876519-UPI                                                       ,15/07/24 ,          50.00     ,           0.00     ,0000419705876519       ,       32325.95  
 15/07/24  ,UPI-APROZONE ENTERPRISES-APROZONEENTERPR39.RZP@ICICI-ICIC0DC0099-419707956449-PAYMENTTOAPROZONE                          ,15/07/24 ,        1424.05     ,           0.00     ,0000419707956449       ,       30901.90  
 15/07/24  ,UPI-EVERSTYLISH LIFESTYL-EVERSTYLISH.RZP@ICICI-ICIC0DC0099-419708645069-PAYMENTTOEVERSTYLI                               ,15/07/24 ,         315.00     ,           0.00     ,0000419708645069       ,       30586.90  
 15/07/24  ,UPI-N BOOKS-Q069210991@YBL-YESB0YBLUPI-419715027572-UPI                                                                  ,15/07/24 ,         640.00     ,           0.00     ,0000419715027572       ,       29946.90  
 15/07/24  ,UPI-BUNDL TECHNOLOGIES P-SWIGGYINSTAMART.RZP@AXISBANK-UTIB0000100-419719507917-PAYVIARAZORPAY                            ,15/07/24 ,         711.00     ,           0.00     ,0000419719507917       ,       29235.90  
 18/07/24  ,UPI-BUNDL TECHNOLOGIES P-SWIGGYUPI@AXB-UTIB0000100-420006758187-UPI                                                      ,18/07/24 ,         180.00     ,           0.00     ,0000420006758187       ,       29055.90  
 18/07/24  ,UPI-SWIGGY-UPISWIGGY@ICICI-ICIC0DC0099-420034011078-UPI                                                                  ,18/07/24 ,         581.00     ,           0.00     ,0000420034011078       ,       28474.90  
 19/07/24  ,UPI-MADHU C S-7892519925@IBL-DBSS0IN0811-420157535299-UPI                                                                ,19/07/24 ,         134.00     ,           0.00     ,0000420157535299       ,       28340.90  
 19/07/24  ,UPI-UBER INDIA SYSTEMS P-UBERINDIASYSTEM971479.RZP@AXISBANK-UTIB0000100-420160703296-UBERRIDE                            ,19/07/24 ,         124.94     ,           0.00     ,0000420160703296       ,       28215.96  
 19/07/24  ,UPI-NAYAZ  PASHA-AMZN0026739137@APL-KKBK0008043-420161506059-UPI                                                         ,19/07/24 ,          89.00     ,           0.00     ,0000420161506059       ,       28126.96  
 19/07/24  ,UPI-SRI GANESH FRUIT JUI-Q695321764@YBL-YESB0YBLUPI-420161542785-UPI                                                     ,19/07/24 ,          75.00     ,           0.00     ,0000420161542785       ,       28051.96  
 19/07/24  ,UPI-BASAVARAJU H P-8105499956@YBL-KARB0000913-420162421200-UPI                                                           ,19/07/24 ,          86.00     ,           0.00     ,0000420162421200       ,       27965.96  
 20/07/24  ,UPI-JIOCINEMA-VIACOM18ONLINE@YBL-YESB0YBLUPI-420235925283-SUBSCRIPTION DEBIT                                             ,20/07/24 ,          29.00     ,           0.00     ,0000420235925283       ,       27936.96  
 20/07/24  ,UPI-SWIGGY-UPISWIGGY@ICICI-ICIC0DC0099-420295623086-UPI                                                                  ,20/07/24 ,         399.00     ,           0.00     ,0000420295623086       ,       27537.96  
 20/07/24  ,UPI-SWIGGY-SWIGGY@YESPAY-YESB0YESUPI-420214161054-UPI                                                                    ,20/07/24 ,         360.00     ,           0.00     ,0000420214161054       ,       27177.96  
 21/07/24  ,UPI-BUNDL TECHNOLOGIES P-SWIGGYINSTAMART.RZP@AXISBANK-UTIB0000100-420341460911-PAYVIARAZORPAY                            ,21/07/24 ,         416.00     ,           0.00     ,0000420341460911       ,       26761.96  
 21/07/24  ,NEFT CR-SBIN0000TBU-ITDTAX REFUND 2024-25 BQFPN9832F-VAISHNAVI NANDAKUMAR-SBIN424203804183                               ,21/07/24 ,           0.00     ,       60140.00     ,SBIN424203804183       ,       86901.96  
 21/07/24  ,UPI-SWIGGY-SWIGGY@YESPAY-YESB0YESUPI-420357694045-UPI                                                                    ,21/07/24 ,         507.00     ,           0.00     ,0000420357694045       ,       86394.96  
 22/07/24  ,UPI-ELIOR BANKUET-PAYTM-70969563@PAYTM-YESB0PTMUPI-420480369678-UPI                                                      ,22/07/24 ,          50.00     ,           0.00     ,0000420480369678       ,       86344.96  
 24/07/24  ,UPI-SWIGGY-SWIGGYSTORES@ICICI-ICIC0DC0099-420666144162-UPI                                                               ,24/07/24 ,         219.00     ,           0.00     ,0000420666144162       ,       86125.96  
 25/07/24  ,UPI-SWIGGY-SWIGGYSTORES@ICICI-ICIC0DC0099-420789582893-UPI                                                               ,25/07/24 ,         299.00     ,           0.00     ,0000420789582893       ,       85826.96  
 25/07/24  ,UPI-BUNDL TECHNOLOGIES P-SWIGGYUPI@AXB-UTIB0000100-420797080014-UPI                                                      ,25/07/24 ,         216.00     ,           0.00     ,0000420797080014       ,       85610.96  
 27/07/24  ,UPI-RAJALAKSHMI  NANDAKU-RAJI.NANDAKUMAR@OKSBI-SBIN0011926-420970438835-UPI                                              ,27/07/24 ,        7000.00     ,           0.00     ,0000420970438835       ,       78610.96  
 28/07/24  ,UPI-GOOGLE INDIA DIGITAL-GPAY-UTILITY@OKPAYAXIS-UTIB0000553-421025572188-UPI                                             ,28/07/24 ,         813.00     ,           0.00     ,0000421025572188       ,       77797.96  
 28/07/24  ,UPI-JAYADEV V M-JAYDEVVM@OKICICI-ICIC0000219-421025569812-UPI                                                            ,28/07/24 ,        1400.00     ,           0.00     ,0000421025569812       ,       76397.96  
 28/07/24  ,UPI-CHIKKEGOWDA-9611906895@AXL-SBIN0040171-421027395363-UPI                                                              ,28/07/24 ,         133.00     ,           0.00     ,0000421027395363       ,       76264.96  
 28/07/24  ,UPI-BLINKIT-BLINKITBYX.RZP@MAIRTEL-AIRP0000001-421031246066-PAYVIARAZORPAY                                               ,28/07/24 ,         520.00     ,           0.00     ,0000421031246066       ,       75744.96  
 28/07/24  ,NEFT DR-ICIC0000650-METANOIA EXPEDITIONS PVT LTD-NETBANK, MUM-N210243171703889-VAISHNAVI NK  BALI                        ,28/07/24 ,       48945.00     ,           0.00     ,N210243171703889       ,       26799.96  
 29/07/24  ,UPI-NIVEDITHA  S-NIVEDITHASUBBURAMAN@OKSBI-SBIN0000944-421152203341-UPI                                                  ,29/07/24 ,          50.00     ,           0.00     ,0000421152203341       ,       26749.96  
 29/07/24  ,UPI-SWIGGY-SWIGGYSTORES@ICICI-ICIC0DC0099-421163526467-UPI                                                               ,29/07/24 ,         373.00     ,           0.00     ,0000421163526467       ,       26376.96  
 30/07/24  ,POS 416021XXXXXX6709 PAY*EAT GOOD TEC                                                                                    ,30/07/24 ,          20.00     ,           0.00     ,0000421202210149       ,       26356.96  
 30/07/24  ,NEFT CR-ICIC0000009-SALARY 2024JUL VISA CONSOLIDATED SU-VAISHNAVI NANDAKUMAR-CMS4355094311 SALARY 2024JUL VISA CONSOLIDA ,30/07/24 ,           0.00     ,      133590.00     ,000CMS4355094311       ,      159946.96  
 30/07/24  ,POS 416021XXXXXX6709 PAY*EAT GOOD TEC                                                                                    ,30/07/24 ,          50.00     ,           0.00     ,0000421206359022       ,      159896.96  
 31/07/24  ,UPI-APROZONE ENTERPRISES-APROZONE@AXL-HDFC0003783-421351524728-PAYMENT FROM PHONE                                        ,31/07/24 ,           0.00     ,        1224.00     ,0000421351524728       ,      161120.96  
 31/07/24  ,ME DC SI 416021XXXXXX6709 GOOGLE PLAY                                                                                    ,31/07/24 ,          35.00     ,           0.00     ,0000421312837577       ,      161085.96  
 01/08/24  ,CC 000537206XXXXXX5466 AUTOPAY SI-TAD                                                                                    ,01/08/24 ,        6475.00     ,           0.00     ,0000000601291952       ,      154610.96  
 01/08/24  ,UPI-TONI AND GUY BROOKFI-D1912AA8.9740402716@ICICI-ICIC0DC0099-421494983918-UPI                                          ,01/08/24 ,          83.00     ,           0.00     ,0000421494983918       ,      154527.96  
 01/08/24  ,UPI-BUNDL TECHNOLOGIES P-SWIGGYUPI@AXB-UTIB0000100-421498082038-UPI                                                      ,01/08/24 ,         310.00     ,           0.00     ,0000421498082038       ,      154217.96  
 01/08/24  ,UPI-VAISHNAVI NANDAKUMAR-VAISHOO.NK@OKHDFCBANK-PUNB0432900-421498132292-UPI                                              ,01/08/24 ,       17000.00     ,           0.00     ,0000421498132292       ,      137217.96  
 01/08/24  ,UPI-K MADHAVI-SATISHBACCHU-2@OKHDFCBANK-HDFC0000214-421498196498-UPI                                                     ,01/08/24 ,       21500.00     ,           0.00     ,0000421498196498       ,      115717.96  
 01/08/24  ,UPI-NANDAKUMAR V V-NKVV2011@OKHDFCBANK-HDFC0000671-421498236269-UPI                                                      ,01/08/24 ,        5000.00     ,           0.00     ,0000421498236269       ,      110717.96  
 01/08/24  ,UPI-RAJALAKSHMI  NANDAKU-RAJI.NANDAKUMAR@OKAXIS-SBIN0011926-421498257464-UPI                                             ,01/08/24 ,        7000.00     ,           0.00     ,0000421498257464       ,      103717.96  
 01/08/24  ,50400292038639- RD INSTALLMENT-AUG 2024                                                                                  ,01/08/24 ,       15000.00     ,           0.00     ,000000000000000        ,       88717.96  
 02/08/24  ,UPI-TROPELET TECHNOLOGIE-RZPJFCTELEPORT@YESBANK-YESB0000001-421531228061-PAYMENTTOTELEPORT                               ,02/08/24 ,        3244.00     ,           0.00     ,0000421531228061       ,       85473.96  
 02/08/24  ,UPI-SWIGGY-SWIGGYSTORES@ICICI-ICIC0DC0099-421534965076-UPI                                                               ,02/08/24 ,         291.00     ,           0.00     ,0000421534965076       ,       85182.96  
 02/08/24  ,UPI-SHATRUDHAN  MAHTO-BHARATPE.90068302064@FBPE-FDRL0001382-421545936875-PAY TO BHARATPE ME                              ,02/08/24 ,         208.00     ,           0.00     ,0000421545936875       ,       84974.96  
 02/08/24  ,UPI-MR MOHAN KUMAR  KG-9742448423@IBL-CBIN0281304-421552863442-UPI                                                       ,02/08/24 ,         222.00     ,           0.00     ,0000421552863442       ,       84752.96  
 03/08/24  ,UPI-MANJE GOWDA S S-MANJUMANJU97246@OKAXIS-IOBA0002838-421678526835-UPI                                                  ,03/08/24 ,         194.00     ,           0.00     ,0000421678526835       ,       84558.96  
 04/08/24  ,UPI-SWIGGY-SWIGGYSTORES@ICICI-ICIC0DC0099-421701438580-UPI                                                               ,04/08/24 ,         309.00     ,           0.00     ,0000421701438580       ,       84249.96  
 04/08/24  ,UPI-VIDYUT RAJWAR-VIDYUT.RAJWAR@AXL-BKID0004717-421708438884-UPI                                                         ,04/08/24 ,          85.00     ,           0.00     ,0000421708438884       ,       84164.96  
 04/08/24  ,UPI-BMRCL-30VWIATOM0001.PAYU@INDUS-INDB0002201-421708650494-UPI                                                          ,04/08/24 ,         120.00     ,           0.00     ,0000421708650494       ,       84044.96  
 04/08/24  ,UPI-VENKATESAN R-9500857535@PTYES-HDFC0000260-421713961556-UPI                                                           ,04/08/24 ,         500.00     ,           0.00     ,0000421713961556       ,       83544.96  
 04/08/24  ,UPI-KRISHNA M H-AMZN0026754430@APL-UBIN0916552-421715189776-UPI                                                          ,04/08/24 ,         103.00     ,           0.00     ,0000421715189776       ,       83441.96  
 04/08/24  ,UPI-KENGERI BUS TERMINAL-RA157868.ONGO@RBL-RATN0000088-421717671674-UPI                                                  ,04/08/24 ,         104.00     ,           0.00     ,0000421717671674       ,       83337.96  
 04/08/24  ,UPI-SYED   MUBARAK-6362968010SYED@YBL-KKBK0008043-421721072909-UPI                                                       ,04/08/24 ,         138.00     ,           0.00     ,0000421721072909       ,       83199.96  
 04/08/24  ,UPI-RAVI M-BHARATPE.90070151465@FBPE-FDRL0001382-421725759577-PAY TO BHARATPE ME                                         ,04/08/24 ,         118.00     ,           0.00     ,0000421725759577       ,       83081.96  
 04/08/24  ,UPI-OAM INDUSTRIES I PVT-OAMINDUSTRIESIPVTLTD.42640534@HDFCBANK-HDFC0000001-421734807608-GENERATING DYNAMIC              ,04/08/24 ,         250.96     ,           0.00     ,0000421734807608       ,       82831.00  
 04/08/24  ,UPI-HEALTHY HABIT DREAM -PAYTMQR1I8T4J6YTA@PAYTM-YESB0PTMUPI-421736371876-UPI                                            ,04/08/24 ,         427.00     ,           0.00     ,0000421736371876       ,       82404.00  
 05/08/24  ,UPI-SWIGGY-UPISWIGGY@ICICI-ICIC0DC0099-421844252224-UPI                                                                  ,05/08/24 ,         164.00     ,           0.00     ,0000421844252224       ,       82240.00  
 05/08/24  ,UPI-BLINKIT-BLINKIT104020.RZP@RXAIRTEL-AIRP0000011-421844699650-BLINKIT                                                  ,05/08/24 ,         352.00     ,           0.00     ,0000421844699650       ,       81888.00  
 05/08/24  ,POS 416021XXXXXX6709 PAY*EAT GOOD TEC                                                                                    ,05/08/24 ,          30.00     ,           0.00     ,0000421804454346       ,       81858.00  
 05/08/24  ,POS 416021XXXXXX6709 PAY*EAT GOOD TEC                                                                                    ,05/08/24 ,          70.00     ,           0.00     ,0000421807591247       ,       81788.00  
 05/08/24  ,POS 416021XXXXXX6709 PAY*EAT GOOD TEC                                                                                    ,05/08/24 ,          70.00     ,           0.00     ,0000421807610211       ,       81718.00  
 05/08/24  ,UPI-BLINKIT-BLINKIT.PAYU@HDFCBANK-HDFC0000499-421868067910-UPIINTENT                                                     ,05/08/24 ,         749.00     ,           0.00     ,0000421868067910       ,       80969.00  
 05/08/24  ,UPI-WISHVISH FOODS PRIVA-Q070722370@YBL-YESB0YBLUPI-421871750837-UPI                                                     ,05/08/24 ,         172.00     ,           0.00     ,0000421871750837       ,       80797.00  
 06/08/24  ,UPI-SWIGGY LIMITED-SWIGGYINSTAMART1ONLINE.GPAY@OKPAYAXIS-UTIB0000553-421989077622-UPI                                    ,06/08/24 ,         127.00     ,           0.00     ,0000421989077622       ,       80670.00  
 06/08/24  ,POS 416021XXXXXX6709 PAY*EAT GOOD TEC                                                                                    ,06/08/24 ,          70.20     ,           0.00     ,0000421906481353       ,       80599.80  
 06/08/24  ,UPI-RANJEET KUMAR-9523160351@YBL-BARB0MOTIHA-421906653529-UPI                                                            ,06/08/24 ,         143.00     ,           0.00     ,0000421906653529       ,       80456.80  
 06/08/24  ,UPI-M N  ANKARAJU-BHARATPE.90070153801@FBPE-FDRL0001382-421920104784-PAY TO BHARATPE ME                                  ,06/08/24 ,         163.00     ,           0.00     ,0000421920104784       ,       80293.80  
 07/08/24  ,UPI-SYED  MASOOD-9900114574@IBL-CNRB0000033-422051715007-UPI                                                             ,07/08/24 ,         150.00     ,           0.00     ,0000422051715007       ,       80143.80  
 07/08/24  ,50400329652447- RD INSTALLMENT-AUG 2024                                                                                  ,07/08/24 ,       10000.00     ,           0.00     ,000000000000000        ,       70143.80  
 09/08/24  ,UPI-SWIGGY LIMITED-SWIGGYINSTAMART1ONLINE.GPAY@OKPAYAXIS-UTIB0000553-422225026557-UPI                                    ,09/08/24 ,         364.00     ,           0.00     ,0000422225026557       ,       69779.80  
 09/08/24  ,UPI-SWIGGY LIMITED-SWIGGY1ONLINE.GPAY@OKPAYAXIS-UTIB0000553-422233243953-UPI                                             ,09/08/24 ,         197.00     ,           0.00     ,0000422233243953       ,       69582.80  
 09/08/24  ,UPI-INDRA JIT KUMAR-9019467123@IBL-ESFB0001001-422237712646-UPI                                                          ,09/08/24 ,         135.00     ,           0.00     ,0000422237712646       ,       69447.80  
 09/08/24  ,UPI-DEVARAJ N S-9008601951@AXL-UJVN0001122-422241885868-UPI                                                              ,09/08/24 ,         133.00     ,           0.00     ,0000422241885868       ,       69314.80  
 09/08/24  ,UPI-SWIGGY LIMITED-SWIGGY1ONLINE.GPAY@OKPAYAXIS-UTIB0000553-422253359446-UPI                                             ,09/08/24 ,         270.00     ,           0.00     ,0000422253359446       ,       69044.80  
 10/08/24  ,UPI-PRABHA DEVI-8002663498@YBL-AIRP0000001-422380872172-UPI                                                              ,10/08/24 ,         120.00     ,           0.00     ,0000422380872172       ,       68924.80  
 10/08/24  ,UPI-VINAY RAY-BHARATPE.8E0P0N3E8L45950@FBPE-FDRL0001382-422384276383-UPI                                                 ,10/08/24 ,         400.00     ,           0.00     ,0000422384276383       ,       68524.80  
 10/08/24  ,UPI-PUNITH H C-9148173990@YBL-CNRB0000033-422388299951-UPI                                                               ,10/08/24 ,         144.00     ,           0.00     ,0000422388299951       ,       68380.80  
 10/08/24  ,UPI-SWIGGY LIMITED-SWIGGY1ONLINE.GPAY@OKPAYAXIS-UTIB0000553-422301536887-UPI                                             ,10/08/24 ,         323.00     ,           0.00     ,0000422301536887       ,       68057.80  
 10/08/24  ,UPI-VIDUSHI SANJAY GANER-VIDUSHIGANERIWALV135@OKHDFCBANK-HDFC0000971-422307306130-UPI                                    ,11/08/24 ,        1500.00     ,           0.00     ,0000422307306130       ,       66557.80  
 11/08/24  ,UPI-RAJALAKSHMI  NANDAKU-RAJI.NANDAKUMAR@OKSBI-SBIN0011926-422416245757-UPI                                              ,11/08/24 ,        1665.00     ,           0.00     ,0000422416245757       ,       64892.80  
 11/08/24  ,UPI-NAVEEN  S-BHARATPE.90069414530@FBPE-FDRL0001382-422432898622-PAY TO BHARATPE ME                                      ,11/08/24 ,         123.00     ,           0.00     ,0000422432898622       ,       64769.80  
 11/08/24  ,UPI-MANOJ KUMAR K A-PAYTMQR1J2B1OXGJM@PAYTM-YESB0PTMUPI-422439444775-UPI                                                 ,11/08/24 ,         137.00     ,           0.00     ,0000422439444775       ,       64632.80  
 11/08/24  ,UPI-MALLESHA B J-MALLESHMALLESH651@YBL-KARB0000128-422443227696-UPI                                                      ,11/08/24 ,         136.00     ,           0.00     ,0000422443227696       ,       64496.80  
 11/08/24  ,UPI-BIERGARTEN DEVARABEE-PAYTM.D13883878933@PTY-YESB0MCHUPI-422449053360-UPI                                             ,11/08/24 ,        1629.00     ,           0.00     ,0000422449053360       ,       62867.80  
 11/08/24  ,UPI-PERIYANATAKI-636205816@YBL-KKBK0008075-422449399482-UPI                                                              ,11/08/24 ,         168.00     ,           0.00     ,0000422449399482       ,       62699.80  
 12/08/24  ,UPI-MADHU M R-MR.MYLARI@AXL-SBIN0014512-422555612458-UPI                                                                 ,12/08/24 ,         163.00     ,           0.00     ,0000422555612458       ,       62536.80  
 12/08/24  ,POS 416021XXXXXX6709 PAY*EAT GOOD TEC                                                                                    ,12/08/24 ,          30.00     ,           0.00     ,0000422504823356       ,       62506.80  
 12/08/24  ,UPI-SUHAS RAJASEKAR-SUHASRAJASEKAR-1@OKHDFCBANK-HDFC0001206-422557436999-UPI                                             ,12/08/24 ,         105.00     ,           0.00     ,0000422557436999       ,       62401.80  
 12/08/24  ,POS 416021XXXXXX6709 PAY*EAT GOOD TEC                                                                                    ,12/08/24 ,          70.20     ,           0.00     ,0000422506943809       ,       62331.60  
 12/08/24  ,POS 416021XXXXXX6709 PAY*EAT GOOD TEC                                                                                    ,12/08/24 ,          60.00     ,           0.00     ,0000422509063022       ,       62271.60  
 12/08/24  ,UPI-SWIGGY LIMITED-SWIGGY1ONLINE.GPAY@OKPAYAXIS-UTIB0000553-422578183654-UPI                                             ,12/08/24 ,         234.00     ,           0.00     ,0000422578183654       ,       62037.60  
 13/08/24  ,SI HGAEP0FE0B0485917014 AIRTEL -13/08/24                                                                                 ,13/08/24 ,         470.82     ,           0.00     ,000000000000000        ,       61566.78  
 13/08/24  ,UPI-SWIGGY LIMITED-SWIGGY1ONLINE.GPAY@OKPAYAXIS-UTIB0000553-422609162344-UPI                                             ,13/08/24 ,         249.00     ,           0.00     ,0000422609162344       ,       61317.78  
 14/08/24  ,UPI-VIGHNESH K P-VIGHNESHKP-2@OKHDFCBANK-HDFC0009434-422765547523-UPI                                                    ,14/08/24 ,         200.00     ,           0.00     ,0000422765547523       ,       61117.78  
 14/08/24  ,UPI-SWIGGY LIMITED-SWIGGY1ONLINE.GPAY@OKPAYAXIS-UTIB0000553-422771698324-UPI                                             ,14/08/24 ,         831.00     ,           0.00     ,0000422771698324       ,       60286.78  
 16/08/24  ,UPI-KAJRAKH-RZPKAJRAKH@YESBANK-YESB0000001-422946095767-PAYMENTTOKAJRAKH                                                 ,16/08/24 ,        1598.00     ,           0.00     ,0000422946095767       ,       58688.78  
 16/08/24  ,UPI-THE SOULED STORE-PAYTM-8753702@PTYBL-YESB0PTMUPI-422952882357-UPI INTENT                                             ,16/08/24 ,         638.00     ,           0.00     ,0000422952882357       ,       58050.78  
 16/08/24  ,UPI-GOOGLE INDIA DIGITAL-GPAY-UTILITY@OKPAYAXIS-UTIB0000553-422953022500-UPI                                             ,16/08/24 ,         814.00     ,           0.00     ,0000422953022500       ,       57236.78  
 16/08/24  ,UPI-BOOKMYSHOW-BOOKMYSHOW@YESPAY-YESB0YESUPI-422965023555-BOOKMYSHOW                                                     ,16/08/24 ,         907.44     ,           0.00     ,0000422965023555       ,       56329.34  
 17/08/24  ,UPI-REDBUS INDIA PRIVATE-REDBUS1ONLINE.GPAY@OKPAYAXIS-UTIB0000553-423073741230-UPI                                       ,17/08/24 ,        2727.90     ,           0.00     ,0000423073741230       ,       53601.44  
 17/08/24  ,UPI-CINEPOLIS GOKULAM GA-CINEPOLISGOKULAMGALL.61725883@HDFCBANK-HDFC0000001-423098344903-UPI                             ,17/08/24 ,         460.00     ,           0.00     ,0000423098344903       ,       53141.44  
 18/08/24  ,UPI-ELAN BEAUTY PARLOUR-ELANBEAUTYPARLOUR.68198079@HDFCBANK-HDFC0000001-423128134604-UPI                                 ,18/08/24 ,        2700.00     ,           0.00     ,0000423128134604       ,       50441.44  
 18/08/24  ,UPI-SHUHAIB T P-PAYTMQR4W4YGWV4UY@PAYTM-YESB0PTMUPI-423137029218-UPI                                                     ,18/08/24 ,         160.00     ,           0.00     ,0000423137029218       ,       50281.44  
 18/08/24  ,UPI-MYNTRA DESIGNS PRIVA-MYNTRA.PAYU@INDUS-INDB0002201-423146563659-UPIINTENT                                            ,18/08/24 ,        2726.00     ,           0.00     ,0000423146563659       ,       47555.44  
 19/08/24  ,UPI-SAGAR H M-BHARATPE.90070728821@FBPE-FDRL0001382-423258696538-PAY TO BHARATPE ME                                      ,19/08/24 ,         245.00     ,           0.00     ,0000423258696538       ,       47310.44  
 19/08/24  ,UPI-BLINKIT-BLINKIT.PAYU@HDFCBANK-HDFC0000499-423258913613-UPIINTENT                                                     ,19/08/24 ,         277.00     ,           0.00     ,0000423258913613       ,       47033.44  
 19/08/24  ,POS 416021XXXXXX6709 PAY*EAT GOOD TEC                                                                                    ,19/08/24 ,          30.00     ,           0.00     ,0000423204140757       ,       47003.44  
 19/08/24  ,POS 416021XXXXXX6709 PAY*EAT GOOD TEC                                                                                    ,19/08/24 ,          70.20     ,           0.00     ,0000423206249961       ,       46933.24  
 19/08/24  ,UPI-DECATHLON SPORTS-DECATHLONSPORTS.RZP@ICICI-ICIC0DC0099-423285735242-PAYMENTTODECATHLON                               ,19/08/24 ,        1747.00     ,           0.00     ,0000423285735242       ,       45186.24  
 19/08/24  ,UPI-NYKAA-NYKAA.CF@HDFCBANK-HDFC0000499-423206078510-2984830138                                                          ,19/08/24 ,        1250.00     ,           0.00     ,0000423206078510       ,       43936.24  
 19/08/24  ,UPI-RAM  BHADHUR-RAMESHSHAHI813@OKSBI-SBIN0040784-423286574767-UPI                                                       ,19/08/24 ,          50.00     ,           0.00     ,0000423286574767       ,       43886.24  
 20/08/24  ,UPI-JIOCINEMA-VIACOM18ONLINE@YBL-YESB0YBLUPI-423346787926-SUBSCRIPTION DEBIT                                             ,20/08/24 ,          29.00     ,           0.00     ,0000423346787926       ,       43857.24  
 20/08/24  ,POS 416021XXXXXX6709 PAY*EAT GOOD TEC                                                                                    ,20/08/24 ,          30.00     ,           0.00     ,0000423304839675       ,       43827.24  
 20/08/24  ,POS 416021XXXXXX6709 PAY*EAT GOOD TEC                                                                                    ,20/08/24 ,          70.20     ,           0.00     ,0000423306945840       ,       43757.04  
 20/08/24  ,UPI-MANJUNATH-Q624087566@YBL-ANDB0002219-423323244326-UPI                                                                ,20/08/24 ,         136.00     ,           0.00     ,0000423323244326       ,       43621.04  
 20/08/24  ,UPI-SWIGGY LIMITED-SWIGGYINSTAMART1ONLINE.GPAY@OKPAYAXIS-UTIB0000553-423326828460-UPI                                    ,20/08/24 ,         478.00     ,           0.00     ,0000423326828460       ,       43143.04  
 20/08/24  ,UPI-AMAZON PAY GIFT CARD-AMAZONPAYGIFTCARDLOAD@RAPL-RATN000RAPL-423316667393-REQUEST FROM AMAZO                          ,20/08/24 ,         200.00     ,           0.00     ,0000423316667393       ,       42943.04  
 21/08/24  ,UPI-BLINKIT-PAYTM-70258461@PAYTM-YESB0PTMUPI-423463110122-BLINKIT PAYMENT                                                ,21/08/24 ,         219.00     ,           0.00     ,0000423463110122       ,       42724.04  
 21/08/24  ,UPI-BALAKRISHNAN R-Q429037224@YBL-YESB0YBLUPI-423471293373-UPI                                                           ,21/08/24 ,          70.00     ,           0.00     ,0000423471293373       ,       42654.04  
 22/08/24  ,UPI-SWIGGY LIMITED-SWIGGY1ONLINE.GPAY@OKPAYAXIS-UTIB0000553-423594940750-UPI                                             ,22/08/24 ,         371.00     ,           0.00     ,0000423594940750       ,       42283.04  
 22/08/24  ,UPI-AAKRITI KESARWANI-AKRITI.KESARWANI18@OKHDFCBANK-HDFC0001208-423512529037-UPI                                         ,22/08/24 ,         650.00     ,           0.00     ,0000423512529037       ,       41633.04  
 23/08/24  ,UPI-KORRA SREEDEVIBAI-PAYTMQR2810050501011OUGYL803TMX@PAYTM-YESB0PTMUPI-423624151647-UPI                                 ,23/08/24 ,         157.00     ,           0.00     ,0000423624151647       ,       41476.04  
 23/08/24  ,UPI-PAVAN M-AMZN0026734558@APL-KARB0000130-423635236819-UPI                                                              ,23/08/24 ,         114.00     ,           0.00     ,0000423635236819       ,       41362.04  
 23/08/24  ,UPI-SWIGGY LIMITED-SWIGGYINSTAMART1ONLINE.GPAY@OKPAYAXIS-UTIB0000553-423635948909-UPI                                    ,23/08/24 ,         432.00     ,           0.00     ,0000423635948909       ,       40930.04  
 23/08/24  ,UPI-SWIGGY LIMITED-SWIGGYINSTAMART1ONLINE.GPAY@OKPAYAXIS-UTIB0000553-423649602784-UPI                                    ,23/08/24 ,         150.00     ,           0.00     ,0000423649602784       ,       40780.04  
 24/08/24  ,UPI-APOLLO CLINIC MARATH-Q070958557@YBL-YESB0YBLUPI-423777586787-UPI                                                     ,24/08/24 ,         800.00     ,           0.00     ,0000423777586787       ,       39980.04  
 24/08/24  ,UPI-SMART BAZAAR  BENGAL-2305852952895-01@JIOPAY-JIOP0000001-423779475973-UPI                                            ,24/08/24 ,         182.33     ,           0.00     ,0000423779475973       ,       39797.71  
 24/08/24  ,UPI-NYKAA-NYKAA.CF@HDFCBANK-HDFC0000240-423723306615-UPI REFUND                                                          ,24/08/24 ,           0.00     ,         660.00     ,0000423723306615       ,       40457.71  
 24/08/24  ,UPI-SWIGGY LIMITED-SWIGGY1ONLINE.GPAY@OKPAYAXIS-UTIB0000553-423794108989-UPI                                             ,24/08/24 ,         330.00     ,           0.00     ,0000423794108989       ,       40127.71  
 25/08/24  ,UPI-MAHESHA G-7619204096@AXL-CNRB0000033-423812841080-UPI                                                                ,25/08/24 ,         175.00     ,           0.00     ,0000423812841080       ,       39952.71  
 25/08/24  ,UPI-CHANDRA SHEKHAR R-8105306774-2@AXL-KKBK0008042-423825307589-UPI                                                      ,25/08/24 ,         133.00     ,           0.00     ,0000423825307589       ,       39819.71  
 25/08/24  ,UPI-RAJALAKSHMI  NANDAKU-RAJI.NANDAKUMAR@OKSBI-SBIN0011926-423835404626-UPI                                              ,25/08/24 ,       10000.00     ,           0.00     ,0000423835404626       ,       29819.71  
 26/08/24  ,POS 416021XXXXXX6709 PAY*EAT GOOD TEC                                                                                    ,26/08/24 ,          30.00     ,           0.00     ,0000423904406759       ,       29789.71  
 26/08/24  ,POS 416021XXXXXX6709 EATGOOD TECHNOLO                                                                                    ,26/08/24 ,          70.20     ,           0.00     ,0000423906935545       ,       29719.51  
 26/08/24  ,UPI-RAJESH P-AMZN0026766994@APL-HDFC0006393-423958075710-UPI                                                             ,26/08/24 ,          52.00     ,           0.00     ,0000423958075710       ,       29667.51  
 26/08/24  ,UPI-VAAYU INTERNATIONAL -9035324051@ICICI-ICIC0DC0099-423960662247-UPI                                                   ,26/08/24 ,       25040.00     ,           0.00     ,0000423960662247       ,        4627.51  
 26/08/24  ,UPI-PALAK RAJESH MUNSHI-MUNSHI.PALAK@OKHDFCBANK-HDFC0000582-423967181643-BIERGARTEN BELLAND                              ,26/08/24 ,           0.00     ,         729.00     ,0000423967181643       ,        5356.51  
 27/08/24  ,POS 416021XXXXXX6709 PAY*EAT GOOD TEC                                                                                    ,27/08/24 ,          30.00     ,           0.00     ,0000424004638224       ,        5326.51  
 27/08/24  ,POS 416021XXXXXX6709 PAY*EAT GOOD TEC                                                                                    ,27/08/24 ,         125.00     ,           0.00     ,0000424008864116       ,        5201.51  
 27/08/24  ,UPI-ARPA  BANERJEE-ARPA.BANERJEE.UTTARPARA@OKSBI-SBIN0001403-424020998544-BADMINTON                                      ,27/08/24 ,         125.00     ,           0.00     ,0000424020998544       ,        5076.51  
 28/08/24  ,UPI-NAZEEM  KHAN-Q738080273@YBL-YESB0YBLUPI-424142486680-UPI                                                             ,28/08/24 ,           5.00     ,           0.00     ,0000424142486680       ,        5071.51  
 29/08/24  ,NEFT CR-ICIC0000009-SALARY 2024AUG VISA CONSOLIDATED SU-VAISHNAVI NANDAKUMAR-CMS4440350082 SALARY 2024AUG VISA CONSOLIDA ,29/08/24 ,           0.00     ,      153492.00     ,000CMS4440350082       ,      158563.51  
 29/08/24  ,UPI-UMARFAROOQ CHANDASHA-MAKANDARFARUK1@YBL-HDFC0008454-424297547819-UPI                                                 ,29/08/24 ,        1000.00     ,           0.00     ,0000424297547819       ,      157563.51  
 31/08/24  ,ME DC SI 416021XXXXXX6709 GOOGLE PLAY SER CYBS S                                                                         ,31/08/24 ,         130.00     ,           0.00     ,0000424412051635       ,      157433.51  
 01/09/24  ,CC 000537206XXXXXX5466 AUTOPAY SI-TAD                                                                                    ,01/09/24 ,       56151.00     ,           0.00     ,0000000607549060       ,      101282.51  
 02/09/24  ,50400292038639- RD INSTALLMENT-SEP 2024                                                                                  ,01/09/24 ,       15000.00     ,           0.00     ,000000000000000        ,       86282.51  
 02/09/24  ,UPI-APOORVA ATUL MISHRA-APOORVAMISHRA13@OKHDFCBANK-HDFC0000019-424649936998-TEST                                         ,02/09/24 ,           1.00     ,           0.00     ,0000424649936998       ,       86281.51  
 02/09/24  ,UPI-K MADHAVI-SATISHBACCHU-2@OKHDFCBANK-HDFC0000214-424649963333-UPI                                                     ,02/09/24 ,       21500.00     ,           0.00     ,0000424649963333       ,       64781.51  
 02/09/24  ,UPI-NANDAKUMAR V V-NKVV2011@OKHDFCBANK-HDFC0000671-424661778179-UPI                                                      ,02/09/24 ,        5000.00     ,           0.00     ,0000424661778179       ,       59781.51  
 05/09/24  ,UPI-PAARTH SWAR DAND-PAARTHDAND-1@OKICICI-FDRL0005555-424901961510-UPI                                                   ,05/09/24 ,        5632.00     ,           0.00     ,0000424901961510       ,       54149.51  
 07/09/24  ,50400329652447- RD INSTALLMENT-SEP 2024                                                                                  ,07/09/24 ,       10000.00     ,           0.00     ,000000000000000        ,       44149.51  
 08/09/24  ,UPI-ARUN KUMAR V-ARUNV1015@OKHDFCBANK-KKBK0008078-425232561550-UPI                                                       ,08/09/24 ,         946.00     ,           0.00     ,0000425232561550       ,       43203.51  
 08/09/24  ,UPI-SWIGGY LIMITED-SWIGGY1ONLINE.GPAY@OKPAYAXIS-UTIB0000553-425233505600-UPI                                             ,08/09/24 ,         332.00     ,           0.00     ,0000425233505600       ,       42871.51  
 08/09/24  ,UPI-GROFERS INDIA PRIVAT-GROFERS1PAYTM@HDFCBANK-HDFC0000499-425258417493-BLINKIT PAYMENT                                 ,08/09/24 ,         343.00     ,           0.00     ,0000425258417493       ,       42528.51  
 09/09/24  ,UPI-SWIGGY LIMITED-SWIGGY1ONLINE.GPAY@OKPAYAXIS-UTIB0000553-425362675056-UPI                                             ,09/09/24 ,         139.00     ,           0.00     ,0000425362675056       ,       42389.51  
 09/09/24  ,UPI-BALU  BALU-BALUGEETHA3948@OKSBI-SBIN0040938-425369324972-UPI                                                         ,09/09/24 ,          60.00     ,           0.00     ,0000425369324972       ,       42329.51  
 09/09/24  ,UPI-APOLLO CLINIC MARATH-Q365754526@YBL-YESB0YBLUPI-425369488629-UPI                                                     ,09/09/24 ,         800.00     ,           0.00     ,0000425369488629       ,       41529.51  
 09/09/24  ,UPI-APOLLO PHARMACY-APOLLOPHARMACYOFFLINE@YBL-YESB0YBLUPI-425372518122-PAYMENT FOR 147712                                ,09/09/24 ,        1036.52     ,           0.00     ,0000425372518122       ,       40492.99  
 09/09/24  ,UPI-MANJUNATHA  V-7676951712@IBL-KKBK0008121-425373218171-UPI                                                            ,09/09/24 ,          56.00     ,           0.00     ,0000425373218171       ,       40436.99  
 09/09/24  ,UPI-SWIGGY LIMITED-SWIGGYINSTAMART1ONLINE.GPAY@OKPAYAXIS-UTIB0000553-425377606161-UPI                                    ,09/09/24 ,         553.00     ,           0.00     ,0000425377606161       ,       39883.99  
 09/09/24  ,UPI-RAM  BHADHUR-RAMESHSHAHI813@OKSBI-SBIN0040784-425395415796-UPI                                                       ,09/09/24 ,          50.00     ,           0.00     ,0000425395415796       ,       39833.99  
 10/09/24  ,UPI-BOOKMYSHOW-BOOKMYSHOW@YESPAY-YESB0YESUPI-425410750320-BOOKMYSHOW                                                     ,10/09/24 ,        8748.22     ,           0.00     ,0000425410750320       ,       31085.77  
 10/09/24  ,IB BILLPAY DR-HDFC5X-653029XXXXXX2274                                                                                    ,10/09/24 ,         586.00     ,           0.00     ,MB10160836563T45       ,       30499.77  
 10/09/24  ,UPI-SWIGGY-UPISWIGGY@ICICI-ICIC0DC0099-425441827968-UPI                                                                  ,10/09/24 ,         188.00     ,           0.00     ,0000425441827968       ,       30311.77  
 10/09/24  ,UPI-SWIGGY LIMITED-SWIGGYINSTAMART1ONLINE.GPAY@OKPAYAXIS-UTIB0000553-425448466188-UPI                                    ,10/09/24 ,         585.00     ,           0.00     ,0000425448466188       ,       29726.77  
 11/09/24  ,UPI-BUNDL TECHNOLOGIES P-SWIGGYUPI@AXB-UTIB0000100-425568047553-UPI                                                      ,11/09/24 ,         276.00     ,           0.00     ,0000425568047553       ,       29450.77  
 12/09/24  ,SI HGAEP015000750354537 AIRTEL -12/09/24                                                                                 ,12/09/24 ,         535.72     ,           0.00     ,000000000000000        ,       28915.05  
 13/09/24  ,UPI-ZEPTO-ZEPTO.PAYU@HDFCBANK-HDFC0000499-425704990216-UPI TRANSACTION                                                   ,13/09/24 ,         527.97     ,           0.00     ,0000425704990216       ,       28387.08  
 14/09/24  ,UPI-SWIGGY LIMITED-SWIGGY1ONLINE.GPAY@OKPAYAXIS-UTIB0000553-425800702214-UPI                                             ,14/09/24 ,         352.00     ,           0.00     ,0000425800702214       ,       28035.08  
 14/09/24  ,UPI-SUMAIYA -UPAY488300KA@UJJIVAN-UJVN0000100-425817583085-UPI                                                           ,14/09/24 ,         121.00     ,           0.00     ,0000425817583085       ,       27914.08  
 14/09/24  ,UPI-SWAMY SON OF MANJE G-7619381406@YBL-HDFC0002998-425825392730-UPI                                                     ,14/09/24 ,         158.00     ,           0.00     ,0000425825392730       ,       27756.08  
 15/09/24  ,UPI-SWIGGY LIMITED-SWIGGYINSTAMART1ONLINE.GPAY@OKPAYAXIS-UTIB0000553-425936189711-UPI                                    ,15/09/24 ,         333.00     ,           0.00     ,0000425936189711       ,       27423.08  
 15/09/24  ,UPI-XXXPGN KOTAK 811 OTP-9535590127@KOTAK-KKBK0008063-425939687118-UPI                                                   ,15/09/24 ,         170.00     ,           0.00     ,0000425939687118       ,       27253.08  
 15/09/24  ,UPI-AVANTIKAS FASHION MA-VYAPAR.169402863644@HDFCBANK-HDFC0000001-425941165637-UPI                                       ,15/09/24 ,        1000.00     ,           0.00     ,0000425941165637       ,       26253.08  
 15/09/24  ,UPI-SADIK PASHA-7829879767@NAVIAXIS-UBIN0824321-425955575678-UPI                                                         ,15/09/24 ,         189.00     ,           0.00     ,0000425955575678       ,       26064.08  
 16/09/24  ,POS 416021XXXXXX6709 PAY*EAT GOOD TEC                                                                                    ,16/09/24 ,          30.00     ,           0.00     ,0000426002640480       ,       26034.08  
 16/09/24  ,POS 416021XXXXXX6709 PAY*EAT GOOD TEC                                                                                    ,16/09/24 ,          70.20     ,           0.00     ,0000426006847906       ,       25963.88  
 16/09/24  ,UPI-VARSHA NANDAKUMAR-VARSHU.NK@OKAXIS-PUNB0425700-426096127076-UPI                                                      ,16/09/24 ,         500.00     ,           0.00     ,0000426096127076       ,       25463.88  
 16/09/24  ,UPI-GODADDY INDIA DOMAIN-GODADDY.CCA@HDFCBANK-HDFC0000499-426020991702-COLLECT                                           ,16/09/24 ,        2109.84     ,           0.00     ,0000426020991702       ,       23354.04  
 17/09/24  ,POS 416021XXXXXX6709 PAY*EAT GOOD TEC                                                                                    ,17/09/24 ,          30.00     ,           0.00     ,0000426102518258       ,       23324.04  
 17/09/24  ,POS 416021XXXXXX6709 PAY*EAT GOOD TEC                                                                                    ,17/09/24 ,          50.00     ,           0.00     ,0000426104599832       ,       23274.04  
 17/09/24  ,POS 416021XXXXXX6709 PAY*EAT GOOD TEC                                                                                    ,17/09/24 ,          70.20     ,           0.00     ,0000426106700620       ,       23203.84  
 19/09/24  ,UPI-SWIGGY LIMITED-SWIGGYINSTAMART1ONLINE.GPAY@OKPAYAXIS-UTIB0000553-426306649836-UPI                                    ,19/09/24 ,         236.00     ,           0.00     ,0000426306649836       ,       22967.84  
 20/09/24  ,UPI-JIOCINEMA-VIACOM18ONLINE@YBL-YESB0YBLUPI-426485443533-SUBSCRIPTION DEBIT                                             ,20/09/24 ,          29.00     ,           0.00     ,0000426485443533       ,       22938.84  
 20/09/24  ,POS 416021XXXXXX6709 PAY*EAT GOOD TEC                                                                                    ,20/09/24 ,          30.00     ,           0.00     ,0000426404216549       ,       22908.84  
 20/09/24  ,POS 416021XXXXXX6709 PAY*EAT GOOD TEC                                                                                    ,20/09/24 ,          70.20     ,           0.00     ,0000426406306799       ,       22838.64  
 20/09/24  ,UPI-SWIGGY LIMITED-SWIGGY1ONLINE.GPAY@OKPAYAXIS-UTIB0000553-426478218948-UPI                                             ,20/09/24 ,         505.00     ,           0.00     ,0000426478218948       ,       22333.64  
 20/09/24  ,UPI-GOOGLE INDIA DIGITAL-GPAY-UTILITY@OKPAYAXIS-UTIB0000553-426484647511-UPI                                             ,20/09/24 ,         548.00     ,           0.00     ,0000426484647511       ,       21785.64  
 21/09/24  ,UPI-RAM  BHADHUR-RAMESHSHAHI813@OKSBI-SBIN0040784-426507455958-UPI                                                       ,21/09/24 ,          50.00     ,           0.00     ,0000426507455958       ,       21735.64  
 21/09/24  ,UPI-TONI AND GUY BROOKFI-D1912AA8.9740402716@ICICI-ICIC0DC0099-426510966661-UPI                                          ,21/09/24 ,          83.00     ,           0.00     ,0000426510966661       ,       21652.64  
 21/09/24  ,UPI-IMRAN  PASHA-AMZN0026773428@APL-KKBK0008061-426519007298-UPI                                                         ,21/09/24 ,         250.00     ,           0.00     ,0000426519007298       ,       21402.64  
 22/09/24  ,UPI-BEERAPPA GARBHAGUDI-GBEERESH2@AXL-SVCB0000174-426644883175-UPI                                                       ,22/09/24 ,         135.00     ,           0.00     ,0000426644883175       ,       21267.64  
 22/09/24  ,UPI-VIGHNESH K P-VIGHNESHKP-2@OKHDFCBANK-HDFC0009434-426648958482-COLDPLAY TIX                                           ,22/09/24 ,       14520.00     ,           0.00     ,0000426648958482       ,        6747.64  
 22/09/24  ,UPI-MADRI  AJAY-7659978965@KOTAK-KKBK0008042-426658663324-UPI                                                            ,22/09/24 ,         124.00     ,           0.00     ,0000426658663324       ,        6623.64  
 23/09/24  ,POS 416021XXXXXX6709 HUNGERBOX                                                                                           ,23/09/24 ,          30.00     ,           0.00     ,0000426708544193       ,        6593.64  
 23/09/24  ,POS 416021XXXXXX6709 PAY*EAT GOOD TEC                                                                                    ,23/09/24 ,          70.20     ,           0.00     ,0000426706698161       ,        6523.44  
 24/09/24  ,UPI-GANDHI-8792737724GANDHI@AXL-SIBL0000231-426823517805-UPI                                                             ,24/09/24 ,         147.00     ,           0.00     ,0000426823517805       ,        6376.44  
 24/09/24  ,POS 416021XXXXXX6709 PAY*EAT GOOD TEC                                                                                    ,24/09/24 ,          70.20     ,           0.00     ,0000426806456245       ,        6306.24  
 24/09/24  ,UPI-DUNZO-DUNZO.CASHFREE@HDFCBANK-HDFC0000240-426844303891-UPI                                                           ,24/09/24 ,         305.00     ,           0.00     ,0000426844303891       ,        6001.24  
 25/09/24  ,UPI-BLINKIT-PAYTM-70258461@PTYBL-YESB0PTMUPI-426980961511-BLINKIT PAYMENT                                                ,25/09/24 ,         427.00     ,           0.00     ,0000426980961511       ,        5574.24  
 26/09/24  ,UPI-SWIGGY-UPISWIGGY@ICICI-ICIC0DC0099-427013096699-UPI                                                                  ,26/09/24 ,         311.00     ,           0.00     ,0000427013096699       ,        5263.24  
 27/09/24  ,UPI-BLINKIT-PAYTM-70258461@PTYBL-YESB0PTMUPI-427149107411-BLINKIT PAYMENT                                                ,27/09/24 ,         483.00     ,           0.00     ,0000427149107411       ,        4780.24  
 27/09/24  ,NEFT CR-ICIC0000009-SALARY 2024SEP VISA CONSOLIDATED SU-VAISHNAVI NANDAKUMAR-CMS4527745000 SALARY 2024SEP VISA CONSOLIDA ,27/09/24 ,           0.00     ,      137529.00     ,000CMS4527745000       ,      142309.24  
 27/09/24  ,UPI-VAISHNAVI NANDAKUMAR-VAISHOO.NK@OKHDFCBANK-PUNB0432900-427154065931-UPI                                              ,27/09/24 ,       17000.00     ,           0.00     ,0000427154065931       ,      125309.24  
 27/09/24  ,UPI-NANDAKUMAR V V-NKVV2011@OKHDFCBANK-HDFC0000671-427157900934-UPI                                                      ,27/09/24 ,        5000.00     ,           0.00     ,0000427157900934       ,      120309.24  
 27/09/24  ,UPI-RAJALAKSHMI  NANDAKU-RAJI.NANDAKUMAR@OKSBI-SBIN0011926-427157916086-UPI                                              ,27/09/24 ,        7000.00     ,           0.00     ,0000427157916086       ,      113309.24  
 27/09/24  ,UPI-SWIGGY LIMITED-SWIGGY1ONLINE.GPAY@OKPAYAXIS-UTIB0000553-427158046725-UPI                                             ,27/09/24 ,         301.00     ,           0.00     ,0000427158046725       ,      113008.24  
 27/09/24  ,UPI-BLINKIT-BLINKIT.PAYU@HDFCBANK-HDFC0000499-427172013401-UPIINTENT                                                     ,27/09/24 ,         227.00     ,           0.00     ,0000427172013401       ,      112781.24  
 28/09/24  ,UPI-MANJUNATHA-6361840600@YBL-UTIB0002926-427297628441-UPI                                                               ,28/09/24 ,         322.00     ,           0.00     ,0000427297628441       ,      112459.24  
 28/09/24  ,UPI-SOMASHEKAR S-BHARATPE90727370831@YESBANKLTD-YESB0YESUPI-427211504009-PAY TO BHARATPE ME                              ,28/09/24 ,         326.00     ,           0.00     ,0000427211504009       ,      112133.24  
 29/09/24  ,UPI-MANJUNATHA-9164327000@IBL-KARB0000447-427341970630-UPI                                                               ,29/09/24 ,         135.00     ,           0.00     ,0000427341970630       ,      111998.24  
 29/09/24  ,UPI-KUNDAN KUMAR-6201746683@PTHDFC-AIRP0000001-427361109517-UPI                                                          ,29/09/24 ,         130.00     ,           0.00     ,0000427361109517       ,      111868.24  
 29/09/24  ,UPI-SWIGGY LIMITED-SWIGGY1ONLINE.GPAY@OKPAYAXIS-UTIB0000553-427368292602-UPI                                             ,29/09/24 ,         280.00     ,           0.00     ,0000427368292602       ,      111588.24  
 30/09/24  ,POS 416021XXXXXX6709 PAY*EAT GOOD TEC                                                                                    ,30/09/24 ,          70.20     ,           0.00     ,0000427406596244       ,      111518.04  
 30/09/24  ,UPI-PALAK RAJESH MUNSHI-MUNSHI.PALAK@OKHDFCBANK-HDFC0000582-427486834188-UPI                                             ,30/09/24 ,        1720.50     ,           0.00     ,0000427486834188       ,      109797.54  
 30/09/24  ,ME DC SI 416021XXXXXX6709 GOOGLE PLAY SER CYBS S                                                                         ,30/09/24 ,         130.00     ,           0.00     ,0000427412849693       ,      109667.54  
 01/10/24  ,INTEREST PAID TILL 30-SEP-2024                                                                                           ,30/09/24 ,           0.00     ,         418.00     ,000000000000000        ,      110085.54  
 01/10/24  ,MATURED RD. TRANSFER CR 50400292038639                                                                                   ,01/10/24 ,           0.00     ,      381281.00     ,000000000000000        ,      491366.54  
 01/10/24  ,UPI-SWIGGY LIMITED-SWIGGY1ONLINE.GPAY@OKPAYAXIS-UTIB0000553-427534495247-UPI                                             ,01/10/24 ,         344.00     ,           0.00     ,0000427534495247       ,      491022.54  
 01/10/24  ,REV-UPI-50100421703462-VAISHOO.NK-1@OKHDFCBANK-427534495247-UPI                                                          ,01/10/24 ,           0.00     ,         344.00     ,0000427534495247       ,      491366.54  
 01/10/24  ,UPI-SWIGGY LIMITED-SWIGGY1ONLINE.GPAY@OKPAYAXIS-UTIB0000553-427534583504-UPI                                             ,01/10/24 ,         344.00     ,           0.00     ,0000427534583504       ,      491022.54  
 01/10/24  ,50100442876684-TPT-OCTOBER RENT-K MADHAVI                                                                                ,01/10/24 ,       22575.00     ,           0.00     ,0000000226272019       ,      468447.54  
 01/10/24  ,UPI-VAISHNAVI NANDAKUMAR-VAISHOO.NK@OKHDFCBANK-PUNB0432900-427535238996-UPI                                              ,01/10/24 ,       17000.00     ,           0.00     ,0000427535238996       ,      451447.54  
 01/10/24  ,UPI-HARISH   GOWDA-9916623504@AXL-KKBK0008043-427544398414-UPI                                                           ,01/10/24 ,         135.00     ,           0.00     ,0000427544398414       ,      451312.54  
 01/10/24  ,UPI-SHRI GAJANANA JUICE -PAYTMQR5ET5CN@PTYS-YESB0PTMUPI-427552739637-UPI                                                 ,01/10/24 ,         180.00     ,           0.00     ,0000427552739637       ,      451132.54  
 01/10/24  ,UPI-PAVAN MEDICALS-PAYTMQRNVB92RJDCZ@PAYTM-YESB0PTMUPI-427554159712-UPI                                                  ,01/10/24 ,          15.00     ,           0.00     ,0000427554159712       ,      451117.54  
 01/10/24  ,UPI-SHARIFF AHMED-UPAY156868KA@UJJIVAN-UJVN0000100-427560651514-UPI                                                      ,01/10/24 ,         149.00     ,           0.00     ,0000427560651514       ,      450968.54  
 02/10/24  ,UPI-PRAKASH K N-9686574446@YBL-UBIN0907057-427668441685-UPI                                                              ,02/10/24 ,         168.00     ,           0.00     ,0000427668441685       ,      450800.54  
 02/10/24  ,CC 000537206XXXXXX5466 AUTOPAY SI-TAD                                                                                    ,02/10/24 ,       21937.00     ,           0.00     ,0000000614032897       ,      428863.54  
 02/10/24  ,CC 000653029XXXXXX2274 AUTOPAY SI-TAD                                                                                    ,02/10/24 ,        2545.00     ,           0.00     ,0000000614068254       ,      426318.54  
 02/10/24  ,UPI-GROFERS INDIA PRIVAT-GROFERSINDIA.RZP@AXISBANK-UTIB0000100-427601699692-PAYVIARAZORPAY                               ,02/10/24 ,         553.00     ,           0.00     ,0000427601699692       ,      425765.54  
 03/10/24  ,UPI-SWIGGY-UPISWIGGY@ICICI-ICIC0DC0099-427723237033-UPI                                                                  ,03/10/24 ,         139.00     ,           0.00     ,0000427723237033       ,      425626.54  
 03/10/24  ,UPI-BALAKRISHNAN R-Q429037224@YBL-YESB0YBLUPI-427754264315-UPI                                                           ,03/10/24 ,          80.00     ,           0.00     ,0000427754264315       ,      425546.54  
 03/10/24  ,UPI-BLINKIT-PAYTM-70258461@PTYBL-YESB0PTMUPI-427760514131-BLINKIT PAYMENT                                                ,03/10/24 ,         261.00     ,           0.00     ,0000427760514131       ,      425285.54  
 03/10/24  ,UPI-CRAFTMATE-CRAFTMATE432040.RZP@ICICI-ICIC0DC0099-427764139769-PAYMENTTOCRAFTMATE                                      ,03/10/24 ,         850.00     ,           0.00     ,0000427764139769       ,      424435.54  
 04/10/24  ,ATW-416021XXXXXX6709-CHBLR020-BANGALORE                                                                                  ,04/10/24 ,        1500.00     ,           0.00     ,0000000000009053       ,      422935.54  
 04/10/24  ,UPI-RANGANATHA-8792534523@YBL-UBIN0568864-427888771420-UPI                                                               ,04/10/24 ,         115.00     ,           0.00     ,0000427888771420       ,      422820.54  
 04/10/24  ,UPI-CHAKALA   VENU-CHAKALA.VENU@YBL-KKBK0008075-427800253687-UPI                                                         ,04/10/24 ,         153.00     ,           0.00     ,0000427800253687       ,      422667.54  
 05/10/24  ,UPI-SWIGGY LIMITED-SWIGGY1ONLINE.GPAY@OKPAYAXIS-UTIB0000553-427952367174-UPI                                             ,05/10/24 ,         310.00     ,           0.00     ,0000427952367174       ,      422357.54  
 06/10/24  ,UPI-RAM  BHADHUR-RAMESHSHAHI813@OKSBI-SBIN0040784-428078952272-UPI                                                       ,06/10/24 ,          50.00     ,           0.00     ,0000428078952272       ,      422307.54  
 06/10/24  ,UPI-CHIKKEGOWDA S O THAM-CHIKKEGOWDA8345@OKICICI-BARB0VJMAGE-428082301020-UPI                                            ,06/10/24 ,         143.00     ,           0.00     ,0000428082301020       ,      422164.54  
 06/10/24  ,UPI-MAGNOLIA BAKERY THE -Q796624771@YBL-YESB0YBLUPI-428086495918-UPI                                                     ,06/10/24 ,         319.00     ,           0.00     ,0000428086495918       ,      421845.54  
 06/10/24  ,UPI-SANZEER HASSAN A-8904016883@YBL-KKBK0008314-428088772434-UPI                                                         ,06/10/24 ,         189.00     ,           0.00     ,0000428088772434       ,      421656.54  
 06/10/24  ,UPI-MR IRFAN BASHA-7676424845@IBL-IDIB000J069-428001982792-UPI                                                           ,06/10/24 ,         280.00     ,           0.00     ,0000428001982792       ,      421376.54  
 06/10/24  ,UPI-SWIGGY LIMITED-SWIGGY1ONLINE.GPAY@OKPAYAXIS-UTIB0000553-428006040025-UPI                                             ,06/10/24 ,         346.00     ,           0.00     ,0000428006040025       ,      421030.54  
 07/10/24  ,POS 416021XXXXXX6709 PAY*EAT GOOD TEC                                                                                    ,07/10/24 ,          30.00     ,           0.00     ,0000428104037192       ,      421000.54  
 07/10/24  ,POS 416021XXXXXX6709 HUNGERBOX                                                                                           ,07/10/24 ,          70.20     ,           0.00     ,0000428112691867       ,      420930.34  
 07/10/24  ,50400329652447- RD INSTALLMENT-OCT 2024                                                                                  ,07/10/24 ,       10000.00     ,           0.00     ,000000000000000        ,      410930.34  
 08/10/24  ,POS 416021XXXXXX6709 PAY*EAT GOOD TEC                                                                                    ,08/10/24 ,          30.00     ,           0.00     ,0000428204944118       ,      410900.34  
 08/10/24  ,POS 416021XXXXXX6709 PAY*EAT GOOD TEC                                                                                    ,08/10/24 ,         200.00     ,           0.00     ,0000428207112193       ,      410700.34  
 08/10/24  ,UPI-BLINKIT-BLINKIT.PAYU@HDFCBANK-HDFC0000499-428289164321-UPIINTENT                                                     ,08/10/24 ,         213.00     ,           0.00     ,0000428289164321       ,      410487.34  
 08/10/24  ,UPI-PRABHU  V-Q809731332@YBL-YESB0YBLUPI-428291781180-UPI                                                                ,08/10/24 ,         200.00     ,           0.00     ,0000428291781180       ,      410287.34  
 08/10/24  ,UPI-BHAVANA S-PAYTMQR154F35JNMG@PAYTM-YESB0PTMUPI-428297948149-UPI                                                       ,08/10/24 ,         315.00     ,           0.00     ,0000428297948149       ,      409972.34  
 09/10/24  ,UPI-MEGHANA S M-SMMEGHANA1@YBL-CNRB0000033-428355269869-UPI                                                              ,09/10/24 ,         233.00     ,           0.00     ,0000428355269869       ,      409739.34  
 10/10/24  ,UPI-SWIGGY LIMITED-SWIGGY1ONLINE.GPAY@OKPAYAXIS-UTIB0000553-428499427815-UPI                                             ,10/10/24 ,         166.00     ,           0.00     ,0000428499427815       ,      409573.34  
 11/10/24  ,UPI-VAISHNAVI NANDAKUMAR-VAISHOO.NK@OKHDFCBANK-PUNB0432900-428520441964-UPI                                              ,11/10/24 ,       50000.00     ,           0.00     ,0000428520441964       ,      359573.34  
 12/10/24  ,UPI-ICCLGROWW-GROWW-BSE.GROWWPAY@HDFCBANK-HDFC0000060-428656508441-PAYMENT REQUEST FO                                    ,12/10/24 ,       50000.00     ,           0.00     ,0000428656508441       ,      309573.34  
 12/10/24  ,UPI-ICCLGROWW-GROWW-BSE.GROWWPAY@HDFCBANK-HDFC0000060-428656506580-PAYMENT REQUEST FO                                    ,12/10/24 ,       20000.00     ,           0.00     ,0000428656506580       ,      289573.34  
 12/10/24  ,UPI-WELLBEINGNUTRITION-WELLBEINGNUTRITION.ESBZ@MAIRTEL-AIRP0000001-428600343765-UPI                                      ,12/10/24 ,        1089.05     ,           0.00     ,0000428600343765       ,      288484.29  
 12/10/24  ,UPI-AMAZON INDIA-AMAZON@RAPL-RATN000RAPL-428615481937-YOU ARE PAYING FOR                                                 ,12/10/24 ,        1990.00     ,           0.00     ,0000428615481937       ,      286494.29  
 12/10/24  ,UPI-GOOGLE INDIA DIGITAL-GPAY-UTILITY@OKPAYAXIS-UTIB0000553-428600749888-UPI                                             ,12/10/24 ,         946.00     ,           0.00     ,0000428600749888       ,      285548.29  
 13/10/24  ,UPI-VIGHNESH K P-VIGHNESHKP-2@OKHDFCBANK-HDFC0009434-428733998823-UPI                                                    ,13/10/24 ,         226.00     ,           0.00     ,0000428733998823       ,      285322.29  
 13/10/24  ,UPI-POTAFO PRIVATE LIMIT-POTAFOPVTLTD247.RZP@AXISBANK-UTIB0000100-610720522874-PAYMENT                                   ,13/10/24 ,        1185.00     ,           0.00     ,0000610720522874       ,      284137.29  
 14/10/24  ,SI HGAFP053830091412571 AIRTEL -12/10/24                                                                                 ,14/10/24 ,         529.82     ,           0.00     ,000000000000000        ,      283607.47  
 16/10/24  ,UPI-PARAGON VENTURES PRI-Q008623744@YBL-YESB0YBLUPI-429051820829-UPI                                                     ,16/10/24 ,        1609.00     ,           0.00     ,0000429051820829       ,      281998.47  
 17/10/24  ,UPI-COCOTTEE-VYAPAR.171346875074@HDFCBANK-HDFC0000001-429112434130-UPI                                                   ,17/10/24 ,         270.00     ,           0.00     ,0000429112434130       ,      281728.47  
 18/10/24  ,UPI-SWIGGY LIMITED-SWIGGY1ONLINE.GPAY@OKPAYAXIS-UTIB0000553-429244144550-UPI                                             ,18/10/24 ,         288.00     ,           0.00     ,0000429244144550       ,      281440.47  
 19/10/24  ,UPI-B MAHAMMAD RAFEEK-8431148572508044@YBL-KARB0000377-429372353026-UPI                                                  ,19/10/24 ,         248.00     ,           0.00     ,0000429372353026       ,      281192.47  
 19/10/24  ,UPI-SWIGGY LIMITED-SWIGGY1ONLINE.GPAY@OKPAYAXIS-UTIB0000553-429305267314-UPI                                             ,19/10/24 ,         285.00     ,           0.00     ,0000429305267314       ,      280907.47  
 20/10/24  ,UPI-JIOCINEMA-VIACOM18ONLINE@YBL-YESB0YBLUPI-429445242562-SUBSCRIPTION DEBIT                                             ,20/10/24 ,          29.00     ,           0.00     ,0000429445242562       ,      280878.47  
 20/10/24  ,UPI-SWIGGY LIMITED-SWIGGY1ONLINE.GPAY@OKPAYAXIS-UTIB0000553-429453734201-UPI                                             ,20/10/24 ,         170.00     ,           0.00     ,0000429453734201       ,      280708.47  
 21/10/24  ,POS 416021XXXXXX6709 PAY*EAT GOOD TEC                                                                                    ,21/10/24 ,          30.00     ,           0.00     ,0000429503043390       ,      280678.47  
 21/10/24  ,POS 416021XXXXXX6709 HUNGERBOX                                                                                           ,21/10/24 ,          70.20     ,           0.00     ,0000429512154246       ,      280608.27  
 21/10/24  ,UPI-PAVITRA HOME APPLIAN-MANARAM22@OKAXIS-KKBK0008075-429595579788-UPI                                                   ,21/10/24 ,        2300.00     ,           0.00     ,0000429595579788       ,      278308.27  
 21/10/24  ,UPI-PATIL CHAITANYA-CHAITUSMILY25@OKHDFCBANK-HDFC0003739-429503933203-ANOOP GIFT                                         ,21/10/24 ,         666.00     ,           0.00     ,0000429503933203       ,      277642.27  
 22/10/24  ,POS 416021XXXXXX6709 PAY*EAT GOOD TEC                                                                                    ,22/10/24 ,          30.00     ,           0.00     ,0000429603767151       ,      277612.27  
 22/10/24  ,UPI-RAJALAKSHMI  NANDAKU-RAJI.NANDAKUMAR@OKSBI-SBIN0011926-429612845480-UPI                                              ,22/10/24 ,        7000.00     ,           0.00     ,0000429612845480       ,      270612.27  
 22/10/24  ,POS 416021XXXXXX6709 PAY*EAT GOOD TEC                                                                                    ,22/10/24 ,          70.20     ,           0.00     ,0000429606920432       ,      270542.07  
 23/10/24  ,UPI-SWIGGY LIMITED-SWIGGYINSTAMART1ONLINE.GPAY@OKPAYAXIS-UTIB0000553-429792095355-UPI                                    ,23/10/24 ,         563.00     ,           0.00     ,0000429792095355       ,      269979.07  
 24/10/24  ,UPI-SWIGGY LIMITED-SWIGGY1ONLINE.GPAY@OKPAYAXIS-UTIB0000553-429814444957-UPI                                             ,24/10/24 ,         398.00     ,           0.00     ,0000429814444957       ,      269581.07  
 24/10/24  ,UPI-SHANTKUMAR-7022624708@YBL-AIRP0000001-429822511547-UPI                                                               ,24/10/24 ,         126.00     ,           0.00     ,0000429822511547       ,      269455.07  
 24/10/24  ,UPI-MAUNESH-Q851941750@YBL-YESB0YBLUPI-429828100562-UPI                                                                  ,24/10/24 ,         112.00     ,           0.00     ,0000429828100562       ,      269343.07  
 25/10/24  ,UPI-GANGADHARA-BHARATPE.90065398640@FBPE-FDRL0001382-429969199032-PAY TO BHARATPE ME                                     ,25/10/24 ,          74.00     ,           0.00     ,0000429969199032       ,      269269.07  
 26/10/24  ,UPI-SHASHIKUMAR R KO-Q643924112@YBL-YESB0YBLUPI-430025219506-UPI                                                         ,26/10/24 ,          98.00     ,           0.00     ,0000430025219506       ,      269171.07  
 26/10/24  ,UPI-BIG BASKET-BIGBASKET.EBZ@HDFCBANK-HDFC0001794-430027544364-UPI                                                       ,26/10/24 ,          40.00     ,           0.00     ,0000430027544364       ,      269131.07  
 26/10/24  ,UPI-SWIGGY LIMITED-SWIGGY1ONLINE.GPAY@OKPAYAXIS-UTIB0000553-430031712805-UPI                                             ,26/10/24 ,         288.00     ,           0.00     ,0000430031712805       ,      268843.07  
 27/10/24  ,UPI-NIVEDITHA  S-NIVEDITHASUBBURAMAN@OKSBI-SBIN0000944-430137416054-UPI                                                  ,27/10/24 ,         168.00     ,           0.00     ,0000430137416054       ,      268675.07  
 27/10/24  ,UPI-ARPA  BANERJEE-ARPA.BANERJEE.UTTARPARA@OKSBI-SBIN0001403-430137417757-UPI                                            ,27/10/24 ,         401.00     ,           0.00     ,0000430137417757       ,      268274.07  
 27/10/24  ,UPI-RAGHAVENDRA ANAND NA-Q502185667@YBL-KARB0000741-430155464178-UPI                                                     ,27/10/24 ,         192.00     ,           0.00     ,0000430155464178       ,      268082.07  
 27/10/24  ,UPI-MUNIRAJU-6361982155@YBL-KARB0000292-430156477027-UPI                                                                 ,27/10/24 ,         151.00     ,           0.00     ,0000430156477027       ,      267931.07  
 27/10/24  ,UPI-AMARESH-AMARESH73378-1@OKSBI-CNRB0000033-430175990045-UPI                                                            ,27/10/24 ,          89.00     ,           0.00     ,0000430175990045       ,      267842.07  
 27/10/24  ,UPI-SWIGGY LIMITED-SWIGGY1ONLINE.GPAY@OKPAYAXIS-UTIB0000553-430179096197-UPI                                             ,27/10/24 ,         306.00     ,           0.00     ,0000430179096197       ,      267536.07  
 28/10/24  ,UPI-SHANKARALING SAGANUR-BHARATPE.90066873380@FBPE-FDRL0001382-430287765075-PAY TO BHARATPE ME                           ,28/10/24 ,         145.00     ,           0.00     ,0000430287765075       ,      267391.07  
 28/10/24  ,POS 416021XXXXXX6709 HUNGERBOX                                                                                           ,28/10/24 ,          30.00     ,           0.00     ,0000430209885351       ,      267361.07  
 28/10/24  ,POS 416021XXXXXX6709 HUNGERBOX                                                                                           ,28/10/24 ,          70.20     ,           0.00     ,0000430212341023       ,      267290.87  
 28/10/24  ,UPI-VAIDHESWARI SELVAM-8105717113@IBL-HDFC0001206-430207698855-UPI                                                       ,28/10/24 ,         129.00     ,           0.00     ,0000430207698855       ,      267161.87  
 28/10/24  ,UPI-KHURSAID MIYA-MIYAKHURSAID@YBL-HDFC0001650-430214119713-UPI                                                          ,28/10/24 ,         129.00     ,           0.00     ,0000430214119713       ,      267032.87  
 28/10/24  ,UPI-SRI GAJANANA FRUIT J-PAYTMQR58170C@PAYTM-YESB0PTMUPI-430214143178-UPI                                                ,28/10/24 ,          40.00     ,           0.00     ,0000430214143178       ,      266992.87  
 28/10/24  ,UPI-SWIGGY LIMITED-SWIGGYINSTAMART1ONLINE.GPAY@OKPAYAXIS-UTIB0000553-430216158470-UPI                                    ,28/10/24 ,         559.00     ,           0.00     ,0000430216158470       ,      266433.87  
 29/10/24  ,NEFT CR-ICIC0000009-SALARY 2024OCT VISA CONSOLIDATED SU-VAISHNAVI NANDAKUMAR-CMS4609713166 SALARY 2024OCT VISA CONSOLIDA ,29/10/24 ,           0.00     ,      136606.00     ,000CMS4609713166       ,      403039.87  
 29/10/24  ,POS 416021XXXXXX6709 PAY*EAT GOOD TEC                                                                                    ,29/10/24 ,          30.00     ,           0.00     ,0000430302102741       ,      403009.87  
 29/10/24  ,POS 416021XXXXXX6709 PAY*EAT GOOD TEC                                                                                    ,29/10/24 ,          70.20     ,           0.00     ,0000430306283237       ,      402939.67  
 29/10/24  ,UPI-PARVATHI   V-SREENIVASULUSREE8791@AXL-KKBK0008094-430348419201-UPI                                                   ,29/10/24 ,          99.00     ,           0.00     ,0000430348419201       ,      402840.67  
 29/10/24  ,UPI-APPLE MEDIA SERVICES-APPLESERVICES.BDSI@HDFCBANK-HDFC0000001-430391670289-UPI MANDATE                                ,29/10/24 ,         399.00     ,           0.00     ,0000430391670289       ,      402441.67  
 29/10/24  ,UPI-MR THIRUMURUGAN  A-ATHIRU512@OKHDFCBANK-CIUB0000112-430358980483-UPI                                                 ,29/10/24 ,        1090.00     ,           0.00     ,0000430358980483       ,      401351.67  
 29/10/24  ,UPI-RAM  BHADHUR-RAMESHSHAHI813@OKSBI-SBIN0040784-430367519719-UPI                                                       ,29/10/24 ,          50.00     ,           0.00     ,0000430367519719       ,      401301.67  
 30/10/24  ,UPI-HPGAS-PAYPHI.HPGAS@ICICI-ICIC0DC0099-430491292135-UPI                                                                ,30/10/24 ,         805.50     ,           0.00     ,0000430491292135       ,      400496.17  
 30/10/24  ,UPI-DINESH-9511313652@YBL-SBIN0032424-430494465306-UPI                                                                   ,30/10/24 ,         100.00     ,           0.00     ,0000430494465306       ,      400396.17  
 30/10/24  ,UPI-CHAI FUSION CAFE-PAYTMQR5YYV0H@PTYS-YESB0PTMUPI-430420170318-UPI                                                     ,30/10/24 ,          50.00     ,           0.00     ,0000430420170318       ,      400346.17  
 30/10/24  ,UPI-KALAVATI-Q081367472@YBL-YESB0YBLUPI-430420781449-UPI                                                                 ,30/10/24 ,          70.00     ,           0.00     ,0000430420781449       ,      400276.17  
 30/10/24  ,UPI-AMIT PARIYAR-AMITPARIYAR230-3@OKAXIS-UTIB0005536-430422995686-UPI                                                    ,30/10/24 ,        2500.00     ,           0.00     ,0000430422995686       ,      397776.17  
 30/10/24  ,ME DC SI 416021XXXXXX6709 GOOGLE PLAY SER CYBS S                                                                         ,30/10/24 ,         130.00     ,           0.00     ,0000430416025405       ,      397646.17  
 31/10/24  ,UPI-WISHVISH FOODS PRIVA-Q823052132@YBL-YESB0YBLUPI-430545375637-UPI                                                     ,31/10/24 ,         196.00     ,           0.00     ,0000430545375637       ,      397450.17  
 31/10/24  ,UPI-SWIGGY LIMITED-SWIGGY1ONLINE.GPAY@OKPAYAXIS-UTIB0000553-430579815968-UPI                                             ,31/10/24 ,         343.00     ,           0.00     ,0000430579815968       ,      397107.17  
